Rk,Player,Team,Conf,G,Att,Yds,Y/A,TD,Y/G,Rec,Yds,Y/R,TD,Y/G,Plays,Yds,Avg,TD,Awards,-9999
1,Breece Hall,Iowa State,Big 12,12,279,1572,5.6,21,131.0,23,180,7.8,2,15.0,302,1752,5.8,23,H-6AA,breece-hall-1
2,Sincere McCormick,UTSA,CUSA,11,249,1467,5.9,11,133.4,20,131,6.6,0,11.9,269,1598,5.9,11,,sincere-mccormick-1
3,Najee Harris,Alabama,SEC,13,251,1466,5.8,26,112.8,43,425,9.9,4,32.7,294,1891,6.4,30,H-5AA,najee-harris-1
4,Michael Carter,North Carolina,ACC,11,156,1245,8.0,9,113.2,25,267,10.7,2,24.3,181,1512,8.4,11,,michael-carter-5
5,Khalil Herbert,Virginia Tech,ACC,11,154,1182,7.7,8,107.5,10,179,17.9,1,16.3,164,1361,8.3,9,,khalil-herbert-1
6,Javonte Williams,North Carolina,ACC,11,157,1140,7.3,19,103.6,25,305,12.2,3,27.7,182,1445,7.9,22,,javonte-williams-1
7,Kevin Harris,South Carolina,SEC,10,185,1138,6.2,15,113.8,21,159,7.6,1,15.9,206,1297,6.3,16,,kevin-harris-5
8,Tyler Allgeier,BYU,Ind,11,150,1130,7.5,13,102.7,14,174,12.4,0,15.8,164,1304,8.0,13,,tyler-allgeier-1
9,Kyren Williams,Notre Dame,ACC,12,211,1125,5.3,13,93.8,35,313,8.9,1,26.1,246,1438,5.8,14,,kyren-williams-1
10,Camerun Peoples,Appalachian State,Sun Belt,12,168,1124,6.7,12,93.7,3,15,5.0,0,1.3,171,1139,6.7,12,,camerun-peoples-1
11,Mohamed Ibrahim,Minnesota,Big Ten,7,201,1076,5.4,15,153.7,8,56,7.0,0,8.0,209,1132,5.4,15,,mohamed-ibrahim-1
12,Jaret Patterson,Buffalo,MAC,6,141,1072,7.6,19,178.7,0,0,,0,0.0,141,1072,7.6,19,,jaret-patterson-1
13,Isaiah Spiller,Texas A&M,SEC,10,188,1036,5.5,9,103.6,20,193,9.7,0,19.3,208,1229,5.9,9,,isaiah-spiller-1
14,Leddie Brown,West Virginia,Big 12,10,199,1010,5.1,9,101.0,31,202,6.5,2,20.2,230,1212,5.3,11,,leddie-brown-1
15,Larry Rountree III,Missouri,SEC,10,209,972,4.7,14,97.2,15,100,6.7,0,10.0,224,1072,4.8,14,,larry-rountree-iii-1
16,Malik Willis,Liberty,Ind,10,141,944,6.7,14,94.4,0,0,,0,0.0,141,944,6.7,14,,malik-willis-1
17,Travis Etienne,Clemson,ACC,12,168,914,5.4,14,76.2,48,588,12.3,2,49.0,216,1502,7.0,16,AA,travis-etienne-1
18,Ulysses Bentley IV,SMU,American,10,170,913,5.4,11,91.3,21,174,8.3,1,17.4,191,1087,5.7,12,,ulysses-bentley-iv-1
19,Jarek Broussard,Colorado,Pac-12,6,156,895,5.7,5,149.2,9,65,7.2,0,10.8,165,960,5.8,5,,jarek-broussard-1
20,Spencer Brown,UAB,CUSA,8,186,889,4.8,10,111.1,5,35,7.0,0,4.4,191,924,4.8,10,,spencer-brown-3
21,Brenden Knox,Marshall,CUSA,10,185,887,4.8,9,88.7,7,86,12.3,1,8.6,192,973,5.1,10,,brenden-knox-1
22,C.J. Marable,Coastal Carolina,Sun Belt,12,169,887,5.2,12,73.9,31,228,7.4,7,19.0,200,1115,5.6,19,,torrance-marable-1
23,Elijah Mitchell,Louisiana,Sun Belt,10,141,878,6.2,8,87.8,16,153,9.6,0,15.3,157,1031,6.6,8,,elijah-mitchell-2
24,Trey Sermon,Ohio State,Big Ten,8,116,870,7.5,4,108.8,12,95,7.9,0,11.9,128,965,7.5,4,,trey-sermon-1
25,Jermar Jefferson,Oregon State,Pac-12,6,133,858,6.5,7,143.0,9,67,7.4,0,11.2,142,925,6.5,7,,jermar-jefferson-1
26,Tank Bigsby,Auburn,SEC,10,138,834,6.0,5,83.4,11,84,7.6,0,8.4,149,918,6.2,5,,tank-bigsby-1
27,Javian Hawkins,Louisville,ACC,8,133,822,6.2,7,102.8,16,127,7.9,1,15.9,149,949,6.4,8,,javian-hawkins-1
28,Mataeo Durant,Duke,ACC,11,120,817,6.8,8,74.3,12,107,8.9,1,9.7,132,924,7.0,9,,mataeo-durant-1
29,Joshua Mack,Liberty,Ind,10,139,797,5.7,4,79.7,6,18,3.0,0,1.8,145,815,5.6,4,,joshua-mack-1
30,Zonovan Knight,North Carolina State,ACC,12,143,788,5.5,10,65.7,20,136,6.8,0,11.3,163,924,5.7,10,,zonovan-knight-1
31,Christopher Rodriguez Jr.,Kentucky,SEC,9,119,785,6.6,11,87.2,1,12,12.0,0,1.3,120,797,6.6,11,,christopher-rodriguez-jr-1
32,Zamir White,Georgia,SEC,10,144,779,5.4,11,77.9,6,37,6.2,0,3.7,150,816,5.4,11,,zamir-white-1
33,Stephon Huderson,Tulane,American,12,128,773,6.0,4,64.4,7,87,12.4,0,7.3,135,860,6.4,4,,stephon-huderson-1
34,Eric Gray,Tennessee,SEC,9,157,772,4.9,4,85.8,30,254,8.5,2,28.2,187,1026,5.5,6,,eric-gray-2
35,Destin Coates,Georgia State,Sun Belt,9,166,769,4.6,7,85.4,12,65,5.4,0,7.2,178,834,4.7,7,,destin-coates-1
36,Tyler Goodson,Iowa,Big Ten,8,143,762,5.3,7,95.3,15,152,10.1,0,19.0,158,914,5.8,7,,tyler-goodson-1
37,Greg McCrae,UCF,American,10,149,758,5.1,10,75.8,14,98,7.0,0,9.8,163,856,5.3,10,,greg-mccrae-1
38,Trey Ragas,Louisiana,Sun Belt,11,131,758,5.8,10,68.9,9,106,11.8,2,9.6,140,864,6.2,12,,trey-ragas-1
39,Jerrion Ealy,Ole Miss,SEC,9,147,745,5.1,9,82.8,15,155,10.3,1,17.2,162,900,5.6,10,,jerrion-ealy-1
40,Cameron Carroll,Tulane,American,12,122,741,6.1,12,61.8,4,49,12.3,1,4.1,126,790,6.3,13,,cameron-carroll-1
41,Kevin Marks,Buffalo,MAC,7,112,741,6.6,7,105.9,4,3,0.8,0,0.4,116,744,6.4,7,,kevin-marks-1
42,Christian Beal,Wake Forest,ACC,9,142,732,5.2,5,81.3,5,42,8.4,0,4.7,147,774,5.3,5,,christian-beal-1
43,Christian Beal-Smith,Wake Forest,ACC,9,142,732,5.2,5,81.3,5,42,8.4,0,4.7,147,774,5.3,5,,christian-beal-smith-1
44,Shai Werts,Georgia Southern,Sun Belt,11,146,720,4.9,11,65.5,0,0,,0,0.0,146,720,4.9,11,,shai-werts-1
45,Trelon Smith,Arkansas,SEC,10,134,710,5.3,5,71.0,22,159,7.2,1,15.9,156,869,5.6,6,,trelon-smith-1
46,Frank Gore Jr.,Southern Mississippi,CUSA,10,121,708,5.9,2,70.8,9,97,10.8,1,9.7,130,805,6.2,3,,frank-gore-jr-1
47,Bijan Robinson,Texas,Big 12,9,86,703,8.2,4,78.1,15,196,13.1,2,21.8,101,899,8.9,6,,bijan-robinson-1
48,Otis Anderson,UCF,American,9,125,687,5.5,4,76.3,14,79,5.6,0,8.8,139,766,5.5,4,,otis-anderson-1
49,Deon Jackson,Duke,ACC,11,161,682,4.2,5,62.0,10,85,8.5,0,7.7,171,767,4.5,5,,deon-jackson-1
50,Toa Taua,Nevada,MWC,8,114,675,5.9,4,84.4,31,214,6.9,1,26.8,145,889,6.1,5,,toa-taua-1
51,Carlos Davis,South Alabama,Sun Belt,11,164,674,4.1,3,61.3,11,104,9.5,0,9.5,175,778,4.4,3,,carlos-davis-4
52,Gerrid Doaks,Cincinnati,American,9,144,673,4.7,7,74.8,14,202,14.4,2,22.4,158,875,5.5,9,,gerrid-doaks-1
53,Demetric Felton,UCLA,Pac-12,6,132,668,5.1,5,111.3,22,159,7.2,3,26.5,154,827,5.4,8,,demetric-felton-1
54,Asim Rose,Kentucky,SEC,11,106,666,6.3,2,60.5,10,83,8.3,0,7.5,116,749,6.5,2,,asim-rose-1
55,Teon Dollard,Akron,MAC,6,112,666,5.9,6,111.0,10,29,2.9,0,4.8,122,695,5.7,6,,teon-dollard-1
56,Rhamondre Stevenson,Oklahoma,Big 12,6,101,665,6.6,7,110.8,18,211,11.7,0,35.2,119,876,7.4,7,,rhamondre-stevenson-1
57,Deandre Torrey,North Texas,CUSA,9,113,656,5.8,6,72.9,4,20,5.0,0,2.2,117,676,5.8,6,,deandre-torrey-1
58,Israel Tucker,Louisiana Tech,CUSA,10,149,648,4.3,4,64.8,10,59,5.9,0,5.9,159,707,4.4,4,,israel-tucker-1
59,Gaej Walker,Western Kentucky,CUSA,12,143,645,4.5,3,53.8,9,87,9.7,0,7.3,152,732,4.8,3,,gaej-walker-1
60,Nelson Smith,Navy,American,10,128,645,5.0,8,64.5,0,0,,0,0.0,128,645,5.0,8,,nelson-smith-1
61,Cam'ron Harris,Miami (FL),ACC,11,126,643,5.1,10,58.5,18,131,7.3,1,11.9,144,774,5.4,11,,camron-harris-1
62,Ricky Person Jr.,North Carolina State,ACC,12,147,643,4.4,4,53.6,18,136,7.6,0,11.3,165,779,4.7,4,,ricky-person-jr-1
63,Deuce Vaughn,Kansas State,Big 12,10,123,642,5.2,7,64.2,25,434,17.4,2,43.4,148,1076,7.3,9,,deuce-vaughn-1
64,Greg Bell,San Diego State,MWC,7,113,637,5.6,6,91.0,11,114,10.4,1,16.3,124,751,6.1,7,,greg-bell-5
65,Vincent Davis,Pitt,ACC,11,143,632,4.4,6,57.5,24,154,6.4,1,14.0,167,786,4.7,7,,vincent-davis-3
66,Sean Tucker,Syracuse,ACC,9,137,626,4.6,4,69.6,8,113,14.1,0,12.6,145,739,5.1,4,,sean-tucker-2
67,Chuba Hubbard,Oklahoma State,Big 12,7,133,625,4.7,5,89.3,8,52,6.5,1,7.4,141,677,4.8,6,,chuba-hubbard-1
68,J.D. King,Georgia Southern,Sun Belt,7,116,625,5.4,5,89.3,3,14,4.7,0,2.0,119,639,5.4,5,,jd-king-1
69,La'darius Jefferson,Western Michigan,MAC,6,112,624,5.6,5,104.0,4,17,4.3,0,2.8,116,641,5.5,5,,ladarius-jefferson-1
70,Rahjai Harris,East Carolina,American,8,128,624,4.9,4,78.0,6,31,5.2,1,3.9,134,655,4.9,5,,rahjai-harris-1
71,Hendon Hooker,Virginia Tech,ACC,8,120,620,5.2,9,77.5,1,16,16.0,0,2.0,121,636,5.3,9,,hendon-hooker-1
72,SaRodorick Thompson,Texas Tech,Big 12,10,109,610,5.6,8,61.0,21,124,5.9,0,12.4,130,734,5.6,8,,sarodorick-thompson-1
73,Malik Cunningham,Louisville,ACC,11,131,609,4.6,7,55.4,0,0,,0,0.0,131,609,4.6,7,,malik-cunningham-1
74,Logan Wright,Georgia Southern,Sun Belt,13,99,602,6.1,4,46.3,8,121,15.1,1,9.3,107,723,6.8,5,,logan-wright-2
75,Asher O'Hara,Middle Tennessee State,CUSA,9,175,601,3.4,7,66.8,1,6,6.0,0,0.7,176,607,3.4,7,,asher-ohara-1
76,Ty Jordan,Utah,Pac-12,5,83,597,7.2,6,119.4,11,126,11.5,0,25.2,94,723,7.7,6,,ty-jordan-1
77,Daetrich Harrington,Appalachian State,Sun Belt,6,106,595,5.6,7,99.2,2,15,7.5,0,2.5,108,610,5.6,7,,daetrich-harrington-1
78,Deion Hankins,UTEP,CUSA,7,121,592,4.9,9,84.6,1,3,3.0,0,0.4,122,595,4.9,9,,deion-hankins-1
79,Desmond Ridder,Cincinnati,American,10,98,592,6.0,12,59.2,0,0,,0,0.0,98,592,6.0,12,,desmond-ridder-1
80,D'Vonte Price,Florida International,CUSA,5,85,581,6.8,4,116.2,5,14,2.8,1,2.8,90,595,6.6,5,,dvonte-price-1
81,Kenneth Walker III,Wake Forest,ACC,8,119,579,4.9,13,72.4,3,30,10.0,0,3.8,122,609,5.0,13,,kenneth-walker-iii-1
82,Jamal Jones,Arkansas State,Sun Belt,11,132,578,4.4,3,52.5,16,89,5.6,0,8.1,148,667,4.5,3,,jamal-jones-4
83,Tyhier Tyler,Army,Ind,7,139,578,4.2,5,82.6,0,0,,0,0.0,139,578,4.2,5,,tyhier-tyler-1
84,Oscar Adaway III,North Texas,CUSA,7,99,572,5.8,3,81.7,2,8,4.0,0,1.1,101,580,5.7,3,,oscar-adaway-iii-1
85,Grayson McCall,Coastal Carolina,Sun Belt,11,111,569,5.1,7,51.7,0,0,,0,0.0,111,569,5.1,7,,grayson-mccall-1
86,Rodrigues Clark,Memphis,American,10,136,561,4.1,2,56.1,10,50,5.0,0,5.0,146,611,4.2,2,,rodrigues-clark-1
87,Stevie Scott,Indiana,Big Ten,8,156,561,3.6,10,70.1,13,86,6.6,0,10.8,169,647,3.8,10,,stevie-scott-1
88,Jordan Travis,Florida State,ACC,8,97,559,5.8,7,69.9,1,5,5.0,0,0.6,98,564,5.8,7,,jordan-travis-1
89,Brennan Armstrong,Virginia,ACC,9,126,552,4.4,5,61.3,0,4,,0,0.4,126,556,4.4,5,,brennan-armstrong-1
90,Austin Jones,Stanford,Pac-12,6,126,550,4.4,9,91.7,21,156,7.4,0,26.0,147,706,4.8,9,,austin-jones-6
91,Xazavian Valladay,Wyoming,MWC,5,99,550,5.6,4,110.0,13,105,8.1,0,21.0,112,655,5.8,4,,xazavian-valladay-1
92,Bobby Cole,New Mexico,MWC,7,97,548,5.6,6,78.3,5,75,15.0,1,10.7,102,623,6.1,7,,bobby-cole-3
93,Dezmon Jackson,Oklahoma State,Big 12,11,100,547,5.5,4,49.7,5,14,2.8,0,1.3,105,561,5.3,4,,dezmon-jackson-1
94,Brittain Brown,UCLA,Pac-12,7,82,543,6.6,4,77.6,6,84,14.0,1,12.0,88,627,7.1,5,,brittain-brown-1
95,Chase Brown,Illinois,Big Ten,8,104,540,5.2,3,67.5,7,64,9.1,0,8.0,111,604,5.4,3,,chase-brown-3
96,D'Eriq King,Miami (FL),ACC,11,130,538,4.1,4,48.9,2,16,8.0,0,1.5,132,554,4.2,4,,deriq-king-1
97,Brock Sturges,Texas State,Sun Belt,12,111,532,4.8,5,44.3,11,116,10.5,1,9.7,122,648,5.3,6,,brock-sturges-1
98,Calvin Hill,Texas State,Sun Belt,12,101,528,5.2,5,44.0,24,173,7.2,0,14.4,125,701,5.6,5,,calvin-hill-4
99,Frank Harris,UTSA,CUSA,12,95,528,5.6,9,44.0,1,8,8.0,0,0.7,96,536,5.6,9,,frank-harris-3
100,Max Duggan,TCU,Big 12,10,116,526,4.5,10,52.6,1,0,0.0,0,0.0,117,526,4.5,10,,max-duggan-1
101,Bryant Koback,Toledo,MAC,6,123,522,4.2,4,87.0,24,228,9.5,2,38.0,147,750,5.1,6,,bryant-koback-1
102,Adrian Martinez,Nebraska,Big Ten,7,91,521,5.7,7,74.4,0,0,,0,0.0,91,521,5.7,7,,adrian-martinez-2
103,Peytton Pickett,Liberty,Ind,11,91,520,5.7,6,47.3,3,10,3.3,0,0.9,94,530,5.6,6,,peytton-pickett-1
104,Corey Taylor II,Tulsa,American,8,105,516,4.9,4,64.5,1,5,5.0,0,0.6,106,521,4.9,4,,corey-taylor-ii-1
105,Jake Funk,Maryland,Big Ten,5,60,516,8.6,3,103.2,10,68,6.8,1,13.6,70,584,8.3,4,,jake-funk-1
106,Kimani Vidal,Troy,Sun Belt,9,101,516,5.1,4,57.3,26,225,8.7,0,25.0,127,741,5.8,4,,kimani-vidal-1
107,Isiah Pacheco,Rutgers,Big Ten,9,116,515,4.4,3,57.2,19,130,6.8,1,14.4,135,645,4.8,4,,isaih-pacheco-1
108,Tyler Nevens,San Jose State,MWC,8,66,515,7.8,5,64.4,4,7,1.8,0,0.9,70,522,7.5,5,,tyler-nevens-1
109,Master Teague,Ohio State,Big Ten,7,104,514,4.9,8,73.4,5,46,9.2,0,6.6,109,560,5.1,8,,master-teague-1
110,Nate Noel,Appalachian State,Sun Belt,10,82,510,6.2,3,51.0,2,25,12.5,0,2.5,84,535,6.4,3,,nate-noel-1
111,Lew Nichols,Central Michigan,MAC,6,78,507,6.5,4,84.5,10,109,10.9,1,18.2,88,616,7.0,5,,lew-nichols-1
112,Ronnie Rivers,Fresno State,MWC,6,100,507,5.1,7,84.5,27,265,9.8,2,44.2,127,772,6.1,9,,ronnie-rivers-1
113,Matt Corral,Ole Miss,SEC,10,112,506,4.5,4,50.6,0,0,,0,0.0,112,506,4.5,4,,matt-corral-1
114,Dameon Pierce,Florida,SEC,12,106,503,4.7,4,41.9,17,156,9.2,1,13.0,123,659,5.4,5,,dameon-pierce-1
115,David Bailey,Boston College,ACC,10,127,503,4.0,7,50.3,8,64,8.0,1,6.4,135,567,4.2,8,,david-bailey-4
116,Marcus Williams Jr.,Appalachian State,Sun Belt,8,68,503,7.4,3,62.9,3,5,1.7,0,0.6,71,508,7.2,3,,marcus-williams-12
117,Chris Tyree,Notre Dame,ACC,12,73,496,6.8,4,41.3,8,65,8.1,0,5.4,81,561,6.9,4,,chris-tyree-1
118,Charles Williams,Nevada-Las Vegas,MWC,6,116,495,4.3,4,82.5,13,44,3.4,0,7.3,129,539,4.2,4,,charles-williams-8
119,Keyon Brooks,Vanderbilt,SEC,6,120,494,4.1,2,82.3,28,258,9.2,0,43.0,148,752,5.1,2,,keyon-brooks-1
120,Jeff Sims,Georgia Tech,ACC,10,120,492,4.1,6,49.2,0,0,,0,0.0,120,492,4.1,6,,jeff-sims-1
121,Trey Smith,Wyoming,MWC,6,88,488,5.5,5,81.3,3,18,6.0,0,3.0,91,506,5.6,5,,trey-smith-4
122,Ian Book,Notre Dame,ACC,12,116,485,4.2,9,40.4,0,0,,0,0.0,116,485,4.2,9,H-9,ian-book-1
123,Brian Robinson Jr.,Alabama,SEC,13,91,483,5.3,6,37.2,6,26,4.3,0,2.0,97,509,5.2,6,,brian-robinson-jr-1
124,Chevan Cordeiro,Hawaii,MWC,9,116,483,4.2,7,53.7,0,0,,0,0.0,116,483,4.2,7,,chevan-cordeiro-1
125,Jerome Ford,Cincinnati,American,10,73,483,6.6,8,48.3,8,51,6.4,0,5.1,81,534,6.6,8,,jerome-ford-1
126,Reese White,Coastal Carolina,Sun Belt,12,88,478,5.4,6,39.8,3,53,17.7,0,4.4,91,531,5.8,6,,reese-white-1
127,Jakobi Buchanan,Army,Ind,11,111,474,4.3,6,43.1,0,0,,0,0.0,111,474,4.3,6,,jakobi-buchanan-1
128,Deneric Prince,Tulsa,American,8,88,470,5.3,4,58.8,1,11,11.0,0,1.4,89,481,5.4,4,,deneric-prince-1
129,Kobe Lewis,Central Michigan,MAC,6,105,468,4.5,6,78.0,17,106,6.2,1,17.7,122,574,4.7,7,,kobe-lewis-1
130,Tucker Gregg,Georgia State,Sun Belt,10,90,468,5.2,6,46.8,2,10,5.0,0,1.0,92,478,5.2,6,,tucker-gregg-1
131,Brad Roberts,Air Force,MWC,4,64,461,7.2,5,115.3,0,0,,0,0.0,64,461,7.2,5,,brad-roberts-1
132,Jahmyr Gibbs,Georgia Tech,ACC,7,89,460,5.2,4,65.7,24,303,12.6,3,43.3,113,763,6.8,7,,jahmyr-gibbs-1
133,Tre Siggers,North Texas,CUSA,8,85,458,5.4,1,57.3,1,1,1.0,0,0.1,86,459,5.3,1,,tre-siggers-1
134,Harrison Waylee,Northern Illinois,MAC,6,107,456,4.3,1,76.0,8,61,7.6,1,10.2,115,517,4.5,2,,harrison-waylee-1
135,Ty Chandler,Tennessee,SEC,10,100,456,4.6,4,45.6,16,111,6.9,0,11.1,116,567,4.9,4,,ty-chandler-1
136,T.J. Pledger,Oklahoma,Big 12,9,95,451,4.7,5,50.1,9,77,8.6,0,8.6,104,528,5.1,5,,tj-pledger-1
137,Lincoln Pare,Arkansas State,Sun Belt,9,72,450,6.3,1,50.0,12,85,7.1,2,9.4,84,535,6.4,3,,lincoln-pare-1
138,Wesley Kennedy III,Georgia Southern,Sun Belt,8,66,447,6.8,6,55.9,8,163,20.4,0,20.4,74,610,8.2,6,,wesley-kennedy-iii-1
139,Tyrion Davis-Price,LSU,SEC,9,104,446,4.3,3,49.6,8,47,5.9,0,5.2,112,493,4.4,3,,tyrion-davis-price-1
140,Gerald Green,Georgia Southern,Sun Belt,8,71,444,6.3,2,55.5,0,0,,0,0.0,71,444,6.3,2,,gerald-green-5
141,Lopini Katoa,BYU,Ind,11,84,444,5.3,5,40.4,23,293,12.7,3,26.6,107,737,6.9,8,,lopini-katoa-1
142,Keaton Mitchell,East Carolina,American,9,88,443,5.0,2,49.2,11,75,6.8,1,8.3,99,518,5.2,3,,keaton-mitchell-1
143,Travis Dye,Oregon,Pac-12,7,64,443,6.9,1,63.3,9,239,26.6,4,34.1,73,682,9.3,5,,travis-dye-1
144,Alexander Horvath,Purdue,Big Ten,6,89,442,5.0,2,73.7,30,304,10.1,0,50.7,119,746,6.3,2,,alexander-horvath-1
145,DeWayne McBride,UAB,CUSA,6,47,439,9.3,4,73.2,0,0,,0,0.0,47,439,9.3,4,,dewayne-mcbride-1
146,Keyvone Lee,Penn State,Big Ten,9,89,438,4.9,4,48.7,12,66,5.5,0,7.3,101,504,5.0,4,,keyvone-lee-1
147,Caleb Huntley,Ball State,MAC,3,80,437,5.5,6,145.7,1,13,13.0,0,4.3,81,450,5.6,6,,caleb-huntley-1
148,LD Brown,Oklahoma State,Big 12,9,82,437,5.3,2,48.6,6,64,10.7,0,7.1,88,501,5.7,2,,ld-brown-2
149,Xavier White,Texas Tech,Big 12,8,62,436,7.0,2,54.5,21,104,5.0,0,13.0,83,540,6.5,2,,xavier-white-1
150,Kylan Watkins,Memphis,American,11,81,433,5.3,1,39.4,23,154,6.7,1,14.0,104,587,5.6,2,,kylan-watkins-1
151,Mekhi Sargent,Iowa,Big Ten,8,76,432,5.7,7,54.0,1,6,6.0,0,0.8,77,438,5.7,7,,mekhi-sargent-1
152,James Charles,Florida Atlantic,CUSA,9,92,429,4.7,4,47.7,9,55,6.1,0,6.1,101,484,4.8,4,,james-charles-1
153,Shedro Louis,Liberty,Ind,10,61,429,7.0,3,42.9,5,48,9.6,0,4.8,66,477,7.2,3,,shedro-louis-1
154,Darwin Barlow,TCU,Big 12,10,73,428,5.9,4,42.8,9,44,4.9,0,4.4,82,472,5.8,4,,darwin-barlow-1
155,Devonte Lee,Nevada,MWC,9,82,427,5.2,2,47.4,17,96,5.6,0,10.7,99,523,5.3,2,,devonte-lee-1
156,Kyle Porter,Houston,American,7,105,424,4.0,4,60.6,16,95,5.9,1,13.6,121,519,4.3,5,,kyle-porter-1
157,Terry Wilson,Kentucky,SEC,10,104,424,4.1,5,42.4,0,0,,0,0.0,104,424,4.1,5,,terry-wilson-3
158,Tyrell Robinson,Army,Ind,12,60,424,7.1,0,35.3,6,117,19.5,2,9.8,66,541,8.2,2,,tyrell-robinson-2
159,Snoop Conner,Ole Miss,SEC,10,93,421,4.5,8,42.1,12,83,6.9,0,8.3,105,504,4.8,8,,snoop-conner-1
160,Rachaad White,Arizona State,Pac-12,4,42,420,10.0,5,105.0,8,151,18.9,1,37.8,50,571,11.4,6,,rachaad-white-1
161,Christian Anderson,Army,Ind,7,94,419,4.5,4,59.9,0,0,,0,0.0,94,419,4.5,4,,christian-anderson-2
162,Roschon Johnson,Texas,Big 12,10,80,418,5.2,6,41.8,8,51,6.4,1,5.1,88,469,5.3,7,,roschon-johnson-1
163,Zach Evans,TCU,Big 12,9,54,415,7.7,4,46.1,8,76,9.5,0,8.4,62,491,7.9,4,,zach-evans-1
164,De'Montre Tuggle,Ohio,MAC,3,53,403,7.6,6,134.3,2,6,3.0,0,2.0,55,409,7.4,6,,demontre-tuggle-1
165,Javion Posey,Florida Atlantic,CUSA,6,58,403,6.9,3,67.2,0,0,,0,0.0,58,403,6.9,3,,javion-posey-1
166,Jashaun Corbin,Florida State,ACC,9,81,401,5.0,5,44.6,19,115,6.1,0,12.8,100,516,5.2,5,,jashaun-corbin-1
167,Shermari Jones,Coastal Carolina,Sun Belt,12,84,398,4.7,3,33.2,1,9,9.0,0,0.8,85,407,4.8,3,,shermari-jones-1
168,Dedrick Mills,Nebraska,Big Ten,6,84,396,4.7,3,66.0,12,85,7.1,0,14.2,96,481,5.0,3,,dedrick-mills-1
169,Wayne Taulapapa,Virginia,ACC,10,88,395,4.5,5,39.5,12,65,5.4,0,6.5,100,460,4.6,5,,wayne-taulapapa-1
170,Gary Brightwell,Arizona,Pac-12,5,88,390,4.4,1,78.0,13,53,4.1,0,10.6,101,443,4.4,1,,gary-brightwell-1
171,Amare Jones,Tulane,American,10,67,389,5.8,2,38.9,14,101,7.2,0,10.1,81,490,6.0,2,,amare-jones-1
172,Isaiah Williams,Illinois,Big Ten,6,63,389,6.2,1,64.8,0,0,,0,0.0,63,389,6.2,1,,isaiah-williams-7
173,Bo Nix,Auburn,SEC,11,108,388,3.6,7,35.3,0,0,,0,0.0,108,388,3.6,7,,bo-nix-1
174,Kendre Miller,TCU,Big 12,9,54,388,7.2,2,43.1,1,-4,-4.0,0,-0.4,55,384,7.0,2,,kendre-miller-1
175,Justin Fields,Ohio State,Big Ten,8,81,383,4.7,5,47.9,0,0,,0,0.0,81,383,4.7,5,H-7,justin-fields-2
176,Andrew Van Buren,Boise State,MWC,7,111,382,3.4,8,54.6,15,93,6.2,0,13.3,126,475,3.8,8,,andrew-van-buren-1
177,Bentavious Thompson,UCF,American,9,73,382,5.2,5,42.4,3,12,4.0,0,1.3,76,394,5.2,5,,bentavious-thompson-1
178,Bentavious Thompson,UCF,American,9,73,382,5.2,5,42.4,3,12,4.0,0,1.3,76,394,5.2,5,,bentavious-thompson-2
179,Brock Purdy,Iowa State,Big 12,12,87,382,4.4,5,31.8,0,0,,0,0.0,87,382,4.4,5,,brock-purdy-1
180,John Emery Jr.,LSU,SEC,9,75,378,5.0,3,42.0,14,73,5.2,0,8.1,89,451,5.1,3,,john-emery-jr-1
181,Sam Ehlinger,Texas,Big 12,10,113,377,3.3,8,37.7,0,0,,0,0.0,113,377,3.3,8,,sam-ehlinger-1
182,Hassan Haskins,Michigan,Big Ten,6,61,375,6.1,6,62.5,0,0,,0,0.0,61,375,6.1,6,,hassan-haskins-1
183,Seth McGowan,Oklahoma,Big 12,8,58,370,6.4,3,46.3,13,201,15.5,1,25.1,71,571,8.0,4,,seth-mcgowan-1
184,La'Damian Webb,Florida State,ACC,7,69,369,5.3,3,52.7,9,68,7.6,0,9.7,78,437,5.6,3,,ladamian-webb-1
185,Kelley Joiner Jr.,South Florida,American,9,78,368,4.7,1,40.9,8,73,9.1,1,8.1,86,441,5.1,2,,kelley-joiner-jr-1
186,Mike Epstein,Illinois,Big Ten,7,69,367,5.3,4,52.4,2,29,14.5,0,4.1,71,396,5.6,4,,mike-epstein-2
187,Chaton Mobley,Middle Tennessee State,CUSA,9,80,366,4.6,4,40.7,8,46,5.8,2,5.1,88,412,4.7,6,,chaton-mobley-1
188,Devon Achane,Texas A&M,SEC,8,43,364,8.5,4,45.5,5,97,19.4,1,12.1,48,461,9.6,5,,devon-achane-1
189,Luke McCaffrey,Nebraska,Big Ten,7,65,364,5.6,3,52.0,1,5,5.0,0,0.7,66,369,5.6,3,,luke-mccaffrey-1
190,Will Howard,Kansas State,Big 12,9,78,364,4.7,3,40.4,0,0,,0,0.0,78,364,4.7,3,,will-howard-2
191,Tye Evans,Ball State,MAC,8,80,360,4.5,2,45.0,3,38,12.7,0,4.8,83,398,4.8,2,,tye-evans-1
192,Jamale Carothers,Navy,American,10,97,358,3.7,2,35.8,4,103,25.8,1,10.3,101,461,4.6,3,,jamale-carothers-2
193,Lawrance Toafili,Florida State,ACC,8,37,356,9.6,2,44.5,12,120,10.0,0,15.0,49,476,9.7,2,,lawrance-toafili-1
194,Jordan Mason,Georgia Tech,ACC,6,82,352,4.3,2,58.7,7,72,10.3,0,12.0,89,424,4.8,2,,jordan-mason-1
195,Chris Smith,Louisiana,Sun Belt,11,62,350,5.6,1,31.8,16,170,10.6,1,15.5,78,520,6.7,2,,chris-smith-22
196,Jalen Mitchell,Louisville,ACC,7,52,347,6.7,2,49.6,4,33,8.3,0,4.7,56,380,6.8,2,,jalen-mitchell-1
197,Jason Bean,North Texas,CUSA,8,56,346,6.2,5,43.3,0,0,,0,0.0,56,346,6.2,5,,jason-bean-1
198,Miles Reed,Hawaii,MWC,8,82,346,4.2,1,43.3,16,123,7.7,0,15.4,98,469,4.8,1,,miles-reed-1
199,Kene Nwangwu,Iowa State,Big 12,12,61,339,5.6,4,28.3,3,22,7.3,0,1.8,64,361,5.6,4,,kene-nwangwu-1
200,Tre Harbison,Charlotte,CUSA,6,80,337,4.2,4,56.2,1,14,14.0,0,2.3,81,351,4.3,4,,tre-harbison-1
201,Tyrrell Pigrome,Western Kentucky,CUSA,11,105,337,3.2,4,30.6,0,0,,0,0.0,105,337,3.2,4,,tyrrell-pigrome-1
202,Levi Lewis,Louisiana,Sun Belt,11,55,335,6.1,5,30.5,0,0,,0,0.0,55,335,6.1,5,,levi-lewis-1
203,Sean Clifford,Penn State,Big Ten,9,99,335,3.4,3,37.2,0,0,,0,0.0,99,335,3.4,3,,sean-clifford-1
204,Cam Porter,Northwestern,Big Ten,7,81,333,4.1,5,47.6,9,57,6.3,0,8.1,90,390,4.3,5,,cam-porter-1
205,Brian Battie,South Florida,American,8,46,332,7.2,1,41.5,4,35,8.8,0,4.4,50,367,7.3,1,,brian-battie-1
206,Calvin Turner,Hawaii,MWC,9,60,331,5.5,4,36.8,33,546,16.5,6,60.7,93,877,9.4,10,,calvin-turner-2
207,Jahmyl Jeter,Texas State,Sun Belt,9,47,329,7.0,3,36.6,5,21,4.2,0,2.3,52,350,6.7,3,,jahmyl-jeter-1
208,Alec Sinkfield,West Virginia,Big 12,10,78,327,4.2,3,32.7,9,55,6.1,0,5.5,87,382,4.4,3,,alec-sinkfield-1
209,Sheldon Evans,Marshall,CUSA,9,72,327,4.5,4,36.3,9,26,2.9,0,2.9,81,353,4.4,4,,sheldon-evans-1
210,Velton Gardner,Kansas,Big 12,6,72,325,4.5,2,54.2,6,18,3.0,0,3.0,78,343,4.4,2,,velton-gardner-1
211,Deon McIntosh,Washington State,Pac-12,4,52,323,6.2,3,80.8,2,30,15.0,0,7.5,54,353,6.5,3,,deon-mcintosh-1
212,Donald Chaney Jr.,Miami (FL),ACC,11,68,322,4.7,3,29.3,11,143,13.0,0,13.0,79,465,5.9,3,,donald-chaney-jr-1
213,Josh Johnson,Louisiana-Monroe,Sun Belt,8,88,321,3.6,4,40.1,17,54,3.2,1,6.8,105,375,3.6,5,,josh-johnson-8
214,Travis Levy,Boston College,ACC,10,99,321,3.2,0,32.1,35,285,8.1,0,28.5,134,606,4.5,0,,travis-levy-1
215,Jakairi Moses,Western Kentucky,CUSA,11,60,319,5.3,0,29.0,9,38,4.2,0,3.5,69,357,5.2,0,,jakairi-moses-1
216,Kevin Perkins,Southern Mississippi,CUSA,9,67,317,4.7,7,35.2,6,26,4.3,0,2.9,73,343,4.7,7,,kevin-perkins-1
217,T.K. Wilkerson,Tulsa,American,7,80,317,4.0,4,45.3,2,4,2.0,0,0.6,82,321,3.9,4,,tk-wilkerson-1
218,Kairee Robinson,San Jose State,MWC,8,82,313,3.8,2,39.1,19,156,8.2,0,19.5,101,469,4.6,2,,kairee-robinson-1
219,Jo'quavious Marks,Mississippi State,SEC,11,70,312,4.5,3,28.4,60,268,4.5,0,24.4,130,580,4.5,3,,joquavious-marks-1
220,Zac Thomas,Appalachian State,Sun Belt,12,90,312,3.5,2,26.0,0,0,,0,0.0,90,312,3.5,2,,zac-thomas-2
221,Malik Davis,Florida,SEC,12,66,310,4.7,0,25.8,31,377,12.2,0,31.4,97,687,7.1,0,,malik-davis-1
222,Tyler Lavine,SMU,American,10,61,310,5.1,5,31.0,8,93,11.6,0,9.3,69,403,5.8,5,,tyler-lavine-1
223,Rakeem Boyd,Arkansas,SEC,7,82,309,3.8,3,44.1,10,33,3.3,0,4.7,92,342,3.7,3,,rakeem-boyd-2
224,Re'Mahn Davis,Temple,American,4,78,308,3.9,1,77.0,12,62,5.2,0,15.5,90,370,4.1,1,,remahn-davis-1
225,Dorian Thompson-Robinson,UCLA,Pac-12,5,55,306,5.6,3,61.2,0,0,,0,0.0,55,306,5.6,3,,dorian-thompson-robinson-1
226,Tayvon Ruley,Temple,American,7,73,306,4.2,1,43.7,4,30,7.5,0,4.3,77,336,4.4,1,,tayvon-ruley-1
227,James Cook,Georgia,SEC,8,45,303,6.7,3,37.9,16,225,14.1,2,28.1,61,528,8.7,5,,james-cook-2
228,Anthony Adkins,Army,Ind,10,51,302,5.9,4,30.2,0,0,,0,0.0,51,302,5.9,4,,anthony-adkins-1
229,Cornelious Brown,Georgia State,Sun Belt,10,98,301,3.1,7,30.1,0,0,,0,0.0,98,301,3.1,7,,cornelious-brown-1
230,Jalen Berger,Wisconsin,Big Ten,4,60,301,5.0,2,75.3,2,13,6.5,0,3.3,62,314,5.1,2,,jalen-berger-1
231,Garrett Groshek,Wisconsin,Big Ten,6,67,300,4.5,2,50.0,22,119,5.4,0,19.8,89,419,4.7,2,,garrett-groshek-1
232,C'Bo Flemister,Notre Dame,ACC,9,58,299,5.2,5,33.2,2,36,18.0,0,4.0,60,335,5.6,5,,cbo-flemister-1
233,Malcolm Davidson,Florida Atlantic,CUSA,6,42,298,7.1,2,49.7,6,96,16.0,0,16.0,48,394,8.2,2,,malcolm-davidson-1
234,Deshaun Fenwick,South Carolina,SEC,8,54,297,5.5,1,37.1,14,108,7.7,0,13.5,68,405,6.0,1,,deshaun-fenwick-1
235,Haaziq Daniels,Air Force,MWC,6,55,297,5.4,3,49.5,0,0,,0,0.0,55,297,5.4,3,,haaziq-daniels-1
236,TJ McDaniel,SMU,American,4,60,297,5.0,1,74.3,4,11,2.8,0,2.8,64,308,4.8,1,,tj-mcdaniel-1
237,Dontae Smith,Georgia Tech,ACC,10,43,296,6.9,3,29.6,6,52,8.7,0,5.2,49,348,7.1,3,,dontae-smith-1
238,Terion Stewart,Bowling Green,MAC,4,37,295,8.0,4,73.8,2,10,5.0,0,2.5,39,305,7.8,4,,terion-stewart-1
239,Kellen Mond,Texas A&M,SEC,10,74,294,4.0,4,29.4,0,0,,0,0.0,74,294,4.0,4,,kellen-mond-1
240,Ainias Smith,Texas A&M,SEC,10,49,293,6.0,4,29.3,43,564,13.1,6,56.4,92,857,9.3,10,,ainias-smith-1
241,Deamonte Trayanum,Arizona State,Pac-12,4,49,290,5.9,4,72.5,1,5,5.0,0,1.3,50,295,5.9,4,,deamonte-trayanum-1
242,CJ Verdell,Oregon,Pac-12,5,65,285,4.4,3,57.0,9,96,10.7,0,19.2,74,381,5.1,3,,cj-verdell-1
243,Johnny Ford,South Florida,American,7,55,285,5.2,3,40.7,15,125,8.3,1,17.9,70,410,5.9,4,,johnny-ford-1
244,Marquez Cooper,Kent State,MAC,4,56,282,5.0,5,70.5,1,14,14.0,0,3.5,57,296,5.2,5,,marquez-cooper-1
245,Shane Simpson,Virginia,ACC,10,54,278,5.1,2,27.8,13,133,10.2,1,13.3,67,411,6.1,3,,shane-simpson-1
246,B.J. Smith,Troy,Sun Belt,10,73,277,3.8,3,27.7,26,227,8.7,0,22.7,99,504,5.1,3,,bj-smith-1
247,Shaun Shivers,Auburn,SEC,8,62,276,4.5,1,34.5,10,55,5.5,0,6.9,72,331,4.6,1,,shaun-shivers-1
248,Will Jones,Ball State,MAC,6,69,276,4.0,2,46.0,2,11,5.5,0,1.8,71,287,4.0,2,,will-jones-3
249,Devyn Ford,Penn State,Big Ten,6,67,274,4.1,3,45.7,7,24,3.4,0,4.0,74,298,4.0,3,,devyn-ford-1
250,Tyjae Spears,Tulane,American,3,37,274,7.4,2,91.3,2,30,15.0,0,10.0,39,304,7.8,2,,tyjae-spears-1
251,Chance Bell,San Diego State,MWC,7,56,273,4.9,3,39.0,3,26,8.7,0,3.7,59,299,5.1,3,,chance-bell-1
252,Tyler Shough,Oregon,Pac-12,7,66,271,4.1,2,38.7,0,18,,0,2.6,66,289,4.4,2,,tyler-shough-1
253,Spencer Sanders,Oklahoma State,Big 12,9,101,269,2.7,2,29.9,1,1,1.0,0,0.1,102,270,2.6,2,,spencer-sanders-1
254,Sandon McCoy,Army,Ind,11,86,268,3.1,10,24.4,1,-4,-4.0,0,-0.4,87,264,3.0,10,,sandon-mccoy-1
255,A.J. Davis,Pitt,ACC,9,61,266,4.4,1,29.6,10,45,4.5,0,5.0,71,311,4.4,1,,aj-davis-4
256,A.J. Davis Jr.,Pitt,ACC,10,61,266,4.4,1,26.6,10,45,4.5,0,4.5,71,311,4.4,1,,aj-davis-jr-1
257,Andrew Clair,Bowling Green,MAC,4,52,266,5.1,0,66.5,2,28,14.0,0,7.0,54,294,5.4,0,,andrew-clair-1
258,Henry Parrish Jr.,Ole Miss,SEC,10,56,263,4.7,2,26.3,7,59,8.4,0,5.9,63,322,5.1,2,,henry-parrish-jr-1
259,Sean Tyler,Western Michigan,MAC,4,40,263,6.6,2,65.8,11,68,6.2,0,17.0,51,331,6.5,2,,sean-tyler-1
260,Harry Trotter,Kansas State,Big 12,9,72,260,3.6,3,28.9,8,34,4.3,0,3.8,80,294,3.7,3,,harry-trotter-1
261,Will Levis,Penn State,Big Ten,8,82,260,3.2,3,32.5,0,0,,0,0.0,82,260,3.2,3,,will-levis-1
262,Kaegun Williams,San Diego State,MWC,7,54,257,4.8,1,36.7,3,42,14.0,0,6.0,57,299,5.2,1,,kaegun-williams-1
263,Drake Anderson,Northwestern,Big Ten,7,62,256,4.1,2,36.6,4,28,7.0,0,4.0,66,284,4.3,2,,drake-anderson-1
264,Raheem Blackshear,Virginia Tech,ACC,11,68,255,3.8,2,23.2,18,154,8.6,0,14.0,86,409,4.8,2,,raheem-blackshear-1
265,Tahj Brooks,Texas Tech,Big 12,10,69,255,3.7,4,25.5,13,61,4.7,0,6.1,82,316,3.9,4,,tahj-brooks-1
266,Aaron McAllister,Charlotte,CUSA,5,37,254,6.9,3,50.8,6,90,15.0,1,18.0,43,344,8.0,4,,aaron-mcallister-1
267,Bryan Bradford,Kent State,MAC,4,37,254,6.9,0,63.5,1,13,13.0,1,3.3,38,267,7.0,1,,bryan-bradford-1
268,Darius Boone Jr.,Eastern Michigan,MAC,3,44,254,5.8,2,84.7,1,13,13.0,0,4.3,45,267,5.9,2,,darius-boone-jr-1
269,Zach Wilson,BYU,Ind,12,70,254,3.6,10,21.2,2,32,16.0,0,2.7,72,286,4.0,10,H-8,zach-wilson-3
270,Clayton Tune,Houston,American,8,72,253,3.5,5,31.6,1,21,21.0,0,2.6,73,274,3.8,5,,clayton-tune-1
271,Jamyest Williams,Georgia State,Sun Belt,8,47,253,5.4,0,31.6,8,77,9.6,0,9.6,55,330,6.0,0,,jamyest-williams-1
272,Jaylen Warren,Utah State,MWC,3,39,252,6.5,3,84.0,5,33,6.6,0,11.0,44,285,6.5,3,,jaylen-warren-1
273,Justin Henderson,Louisiana Tech,CUSA,7,75,252,3.4,2,36.0,9,37,4.1,0,5.3,84,289,3.4,2,,justin-henderson-2
274,Kenny McIntosh,Georgia,SEC,8,47,251,5.3,1,31.4,10,111,11.1,0,13.9,57,362,6.4,1,,kenny-mcintosh-1
275,Jermaine Brown Jr.,UAB,CUSA,9,63,250,4.0,1,27.8,8,32,4.0,0,3.6,71,282,4.0,1,,jermaine-brown-jr-1
276,Keaontay Ingram,Texas,Big 12,6,53,250,4.7,1,41.7,11,103,9.4,1,17.2,64,353,5.5,2,,keaontay-ingram-1
277,Khalan Griffin,Rice,CUSA,5,72,249,3.5,0,49.8,3,45,15.0,0,9.0,75,294,3.9,0,,khalan-griffin-1
278,Max Gilliam,Nevada-Las Vegas,MWC,6,61,248,4.1,2,41.3,0,0,,0,0.0,61,248,4.1,2,,max-gilliam-1
279,Peyton Ramsey,Northwestern,Big Ten,9,84,247,2.9,3,27.4,0,0,,0,0.0,84,247,2.9,3,,peyton-ramsey-1
280,Cooper Lutz,Syracuse,ACC,10,43,246,5.7,1,24.6,8,56,7.0,0,5.6,51,302,5.9,1,,cooper-lutz-1
281,Jamontez Woods,Troy,Sun Belt,11,46,245,5.3,1,22.3,13,89,6.8,0,8.1,59,334,5.7,1,,jamontez-woods-1
282,Jase McClellan,Alabama,SEC,11,23,245,10.7,2,22.3,1,1,1.0,0,0.1,24,246,10.3,2,,jase-mcclellan-1
283,Tyler Badie,Missouri,SEC,10,48,242,5.0,4,24.2,28,333,11.9,2,33.3,76,575,7.6,6,,tyler-badie-1
284,Dustin Crum,Kent State,MAC,4,44,240,5.5,4,60.0,0,0,,0,0.0,44,240,5.5,4,,dustin-crum-1
285,Wan'Dale Robinson,Nebraska,Big Ten,8,46,240,5.2,1,30.0,51,461,9.0,1,57.6,97,701,7.2,2,,wandale-robinson-1
286,Brenden Brady,UTSA,CUSA,6,50,239,4.8,1,39.8,7,48,6.9,0,8.0,57,287,5.0,1,,brenden-brady-1
287,Jemel Jones,Army,Ind,5,42,238,5.7,3,47.6,0,0,,0,0.0,42,238,5.7,3,,jemel-jones-1
288,Vavae Malepeai,USC,Pac-12,5,54,238,4.4,3,47.6,16,64,4.0,0,12.8,70,302,4.3,3,,vavae-malepeai-1
289,Keytaon Thompson,Virginia,ACC,9,39,234,6.0,3,26.0,7,98,14.0,3,10.9,46,332,7.2,6,,keytaon-thompson-1
290,Asa Martin,Memphis,American,11,55,233,4.2,1,21.2,10,105,10.5,0,9.5,65,338,5.2,1,,asa-martin-1
291,Nate Jones,New Mexico,MWC,6,49,232,4.7,4,38.7,0,0,,0,0.0,49,232,4.7,4,,nate-jones-9
292,Nathaniel Jones,New Mexico,MWC,6,49,232,4.7,4,38.7,0,0,,0,0.0,49,232,4.7,4,,nathaniel-jones-1
293,Justin Hall,Ball State,MAC,7,30,231,7.7,1,33.0,49,665,13.6,4,95.0,79,896,11.3,5,,justin-hall-3
294,Isaiah Bowser,Northwestern,Big Ten,7,78,230,2.9,1,32.9,8,52,6.5,1,7.4,86,282,3.3,2,,isaiah-bowser-1
295,Daniel Hishaw Jr.,Kansas,Big 12,8,52,229,4.4,2,28.6,5,28,5.6,0,3.5,57,257,4.5,2,,daniel-hishaw-jr-1
296,Jamious Griffin,Georgia Tech,ACC,8,47,229,4.9,2,28.6,4,61,15.3,0,7.6,51,290,5.7,2,,jamious-griffin-1
297,Kavosiey Smoke,Kentucky,SEC,7,47,229,4.9,1,32.7,5,25,5.0,0,3.6,52,254,4.9,1,,kavosiey-smoke-1
298,Michael Pratt,Tulane,American,10,115,229,2.0,8,22.9,0,0,,0,0.0,115,229,2.0,8,,michael-pratt-1
299,Caziah Holmes,Penn State,Big Ten,9,51,227,4.5,2,25.2,6,37,6.2,0,4.1,57,264,4.6,2,,caziah-holmes-1
300,Sean McGrew,Washington,Pac-12,4,43,227,5.3,4,56.8,3,13,4.3,0,3.3,46,240,5.2,4,,sean-mcgrew-1
301,Dillon Johnson,Mississippi State,SEC,11,51,225,4.4,4,20.5,36,157,4.4,0,14.3,87,382,4.4,4,,dillon-johnson-1
302,Jordan Byrd,San Diego State,MWC,8,35,225,6.4,2,28.1,7,12,1.7,0,1.5,42,237,5.6,2,,jordan-byrd-1
303,Dominic Richardson,Oklahoma State,Big 12,7,44,223,5.1,3,31.9,1,12,12.0,0,1.7,45,235,5.2,3,,dominic-richardson-1
304,Hassan Hall,Louisville,ACC,8,54,223,4.1,2,27.9,3,6,2.0,0,0.8,57,229,4.0,2,,hassan-hall-1
305,Jayden Daniels,Arizona State,Pac-12,4,33,223,6.8,4,55.8,0,0,,0,0.0,33,223,6.8,4,,jayden-daniels-1
306,Matt Laroche,Georgia Southern,Sun Belt,13,45,223,5.0,0,17.2,4,9,2.3,0,0.7,49,232,4.7,0,,matt-laroche-1
307,Juwuan Price,New Mexico State,Ind,2,33,222,6.7,1,111.0,5,7,1.4,0,3.5,38,229,6.0,1,,juwuan-price-1
308,Michael Wiley,Arizona,Pac-12,5,31,222,7.2,3,44.4,8,33,4.1,0,6.6,39,255,6.5,3,,michael-wiley-3
309,Jordon Simmons,Michigan State,Big Ten,5,56,219,3.9,0,43.8,5,34,6.8,0,6.8,61,253,4.1,0,,jordon-simmons-1
310,Daijun Edwards,Georgia,SEC,9,37,218,5.9,1,24.2,1,3,3.0,0,0.3,38,221,5.8,1,,daijun-edwards-1
311,Jaxson Kincaide,Western Michigan,MAC,5,31,218,7.0,2,43.6,5,44,8.8,0,8.8,36,262,7.3,2,,jaxson-kincaide-1
312,Emory Jones,Florida,SEC,9,32,217,6.8,2,24.1,0,0,,0,0.0,32,217,6.8,2,,emory-jones-1
313,Xavier Williams,Kent State,MAC,4,27,216,8.0,3,54.0,0,0,,0,0.0,27,216,8.0,3,,xavier-williams-2
314,Nay'quan Wright,Florida,SEC,11,54,213,3.9,2,19.4,19,219,11.5,0,19.9,73,432,5.9,2,,nayquan-wright-1
315,Knowledge McDaniel,Marshall,CUSA,9,35,212,6.1,2,23.6,0,0,,0,0.0,35,212,6.1,2,,knowledge-mcdaniel-1
316,Joshua Fields,UTEP,CUSA,8,67,211,3.1,1,26.4,2,12,6.0,0,1.5,69,223,3.2,1,,joshua-fields-1
317,A'Jon Vivens,Colorado State,MWC,4,49,210,4.3,1,52.5,1,1,1.0,0,0.3,50,211,4.2,1,,ajon-vivens-1
318,Xavier Arline,Navy,American,5,59,210,3.6,0,42.0,0,0,,0,0.0,59,210,3.6,0,,xavier-arline-1
319,Evan Hull,Northwestern,Big Ten,9,25,209,8.4,2,23.2,6,41,6.8,0,4.6,31,250,8.1,2,,evan-hull-2
320,Jaylan Knighton,Miami (FL),ACC,9,52,209,4.0,1,23.2,11,135,12.3,1,15.0,63,344,5.5,2,,jaylan-knighton-1
321,Micah Kelly,Toledo,MAC,6,44,208,4.7,2,34.7,5,24,4.8,0,4.0,49,232,4.7,2,,micah-kelly-1
322,Sam Noyer,Colorado,Pac-12,6,52,208,4.0,5,34.7,0,0,,0,0.0,52,208,4.0,5,,sam-noyer-1
323,Darius Maberry,Southern Mississippi,CUSA,6,37,207,5.6,2,34.5,0,0,,0,0.0,37,207,5.6,2,,darius-maberry-1
324,Feleipe Franks,Arkansas,SEC,10,105,204,1.9,1,20.4,0,0,,0,0.0,105,204,1.9,1,,feleipe-franks-1
325,Nathaniel Peat,Stanford,Pac-12,6,29,204,7.0,1,34.0,0,0,,0,0.0,29,204,7.0,1,,nathaniel-peat-1
326,Nick Nash,San Jose State,MWC,8,40,204,5.1,1,25.5,0,0,,0,0.0,40,204,5.1,1,,nick-nash-1
327,Trevor Lawrence,Clemson,ACC,10,68,203,3.0,8,20.3,1,8,8.0,0,0.8,69,211,3.1,8,H-2,trevor-lawrence-1
328,Johnny Langan,Rutgers,Big Ten,9,56,201,3.6,4,22.3,2,10,5.0,0,1.1,58,211,3.6,4,,johnny-langan-1
329,Connor Heyward,Michigan State,Big Ten,7,65,200,3.1,0,28.6,18,71,3.9,2,10.1,83,271,3.3,2,,connor-heyward-1
330,D.J. Williams,Auburn,SEC,7,38,199,5.2,3,28.4,7,40,5.7,0,5.7,45,239,5.3,3,,dj-williams-7
331,Emari Demercado,TCU,Big 12,8,46,199,4.3,0,24.9,10,110,11.0,0,13.8,56,309,5.5,0,,emari-demercado-1
332,Craig Williams,Baylor,Big 12,4,26,197,7.6,2,49.3,0,0,,0,0.0,26,197,7.6,2,,craig-williams-2
333,Justin Tomlin,Georgia Southern,Sun Belt,8,38,197,5.2,1,24.6,0,0,,0,0.0,38,197,5.2,1,,justin-tomlin-1
334,Pooka Williams,Kansas,Big 12,4,51,196,3.8,2,49.0,6,31,5.2,0,7.8,57,227,4.0,2,,pooka-williams-1
335,Andrew Peasley,Utah State,MWC,5,22,195,8.9,1,39.0,0,0,,0,0.0,22,195,8.9,1,,andrew-peasley-1
336,Juma Otoviano,Rice,CUSA,2,45,195,4.3,0,97.5,1,8,8.0,0,4.0,46,203,4.4,0,,juma-otoviano-1
337,Boogie Knight,Akron,MAC,6,39,194,5.0,0,32.3,3,25,8.3,0,4.2,42,219,5.2,0,,boogie-knight-1
338,Damien Moore,California,Pac-12,4,38,194,5.1,0,48.5,1,10,10.0,0,2.5,39,204,5.2,0,,damien-moore-1
339,Kendall Milton,Georgia,SEC,7,35,193,5.5,0,27.6,1,22,22.0,0,3.1,36,215,6.0,0,,kendall-milton-1
340,Noah Vedral,Rutgers,Big Ten,7,68,193,2.8,1,27.6,0,-9,,0,-1.3,68,184,2.7,1,,noah-vedral-1
341,Erin Collins,Northern Illinois,MAC,6,50,192,3.8,4,32.0,2,3,1.5,0,0.5,52,195,3.8,4,,erin-collins-2
342,Mulbah Car,Houston,American,7,52,192,3.7,2,27.4,6,32,5.3,0,4.6,58,224,3.9,2,,mulbah-car-1
343,Preston Hutchinson,Eastern Michigan,MAC,6,87,192,2.2,8,32.0,0,0,,0,0.0,87,192,2.2,8,,preston-hutchinson-1
344,Nakia Watson,Wisconsin,Big Ten,6,53,191,3.6,3,31.8,0,0,,0,0.0,53,191,3.6,3,,nakia-watson-1
345,Lyn-J Dixon,Clemson,ACC,10,42,190,4.5,2,19.0,3,21,7.0,0,2.1,45,211,4.7,2,,lyn-j-dixon-1
346,Marquavius Weaver,Memphis,American,11,37,190,5.1,1,17.3,1,8,8.0,0,0.7,38,198,5.2,1,,marquavius-weaver-1
347,Ronald Awatt,UTEP,CUSA,6,42,190,4.5,3,31.7,0,0,,0,0.0,42,190,4.5,3,,ronald-awatt-1
348,Jalen Holston,Virginia Tech,ACC,10,40,189,4.7,2,18.9,3,58,19.3,0,5.8,43,247,5.7,2,,jalen-holston-1
349,Shaun Peterson Jr.,Florida International,CUSA,3,28,188,6.7,2,62.7,0,0,,0,0.0,28,188,6.7,2,,shaun-peterson-jr-1
350,Marcus Major,Oklahoma,Big 12,10,35,187,5.3,3,18.7,2,29,14.5,0,2.9,37,216,5.8,3,,marcus-major-1
351,Ja'Veon Marlow,Vanderbilt,SEC,4,46,186,4.0,0,46.5,4,-3,-0.8,0,-0.8,50,183,3.7,0,,javeon-marlow-1
352,Samson Evans,Eastern Michigan,MAC,4,41,185,4.5,1,46.3,6,46,7.7,0,11.5,47,231,4.9,1,,samson-evans-1
353,Dae Dae Hunter,Hawaii,MWC,9,46,183,4.0,2,20.3,12,71,5.9,2,7.9,58,254,4.4,4,,dae-dae-hunter-1
354,DJ Williams,Auburn,SEC,8,32,183,5.7,2,22.9,6,35,5.8,0,4.4,38,218,5.7,2,,dj-williams-9
355,Braxton Burmeister,Virginia Tech,ACC,6,46,182,4.0,2,30.3,0,0,,0,0.0,46,182,4.0,2,,braxton-burmeister-1
356,Brandon Lewis,Air Force,MWC,5,20,180,9.0,1,36.0,9,79,8.8,0,15.8,29,259,8.9,1,,brandon-lewis-4
357,Devonta'e Henry-Cole,Utah State,MWC,5,41,180,4.4,0,36.0,3,11,3.7,0,2.2,44,191,4.3,0,,devontae-henry-cole-1
358,Maurice Burkley,Louisville,ACC,8,33,180,5.5,1,22.5,3,21,7.0,0,2.6,36,201,5.6,1,,maurice-burkley-1
359,Terrion Avery,South Alabama,Sun Belt,10,51,180,3.5,1,18.0,6,20,3.3,0,2.0,57,200,3.5,1,,terrion-avery-1
360,Cam Wiley,Minnesota,Big Ten,7,29,179,6.2,1,25.6,4,26,6.5,1,3.7,33,205,6.2,2,,cam-wiley-1
361,Timothy Jackson,Air Force,MWC,2,34,178,5.2,0,89.0,0,0,,0,0.0,34,178,5.2,0,,timothy-jackson-1
362,Stephen Carr,USC,Pac-12,6,46,176,3.8,2,29.3,10,64,6.4,0,10.7,56,240,4.3,2,,stephen-carr-2
363,Grant Wells,Marshall,CUSA,10,54,174,3.2,2,17.4,0,0,,0,0.0,54,174,3.2,2,,grant-wells-1
364,Dillon Gabriel,UCF,American,10,72,169,2.3,2,16.9,0,0,,0,0.0,72,169,2.3,2,,dillon-gabriel-1
365,Shaun Peterson Jr.,Florida International,CUSA,3,28,168,6.0,2,56.0,0,0,,0,0.0,28,168,6.0,2,,shaun-peterson-jr-2
366,Markese Stepp,USC,Pac-12,5,45,165,3.7,3,33.0,3,28,9.3,0,5.6,48,193,4.0,3,,markese-stepp-1
367,Nic Smith,North Texas,CUSA,7,35,164,4.7,0,23.4,0,0,,0,0.0,35,164,4.7,0,,nic-smith-1
368,Kadarius Toney,Florida,SEC,11,19,161,8.5,1,14.6,70,984,14.1,10,89.5,89,1145,12.9,11,,kadarius-toney-1
369,Myles Fells,Navy,American,10,25,161,6.4,0,16.1,3,108,36.0,1,10.8,28,269,9.6,1,,myles-fells-1
370,Spencer Rattler,Oklahoma,Big 12,11,81,160,2.0,6,14.5,0,0,,0,0.0,81,160,2.0,6,,spencer-rattler-1
371,Kay'ron Adams,Rutgers,Big Ten,9,35,159,4.5,1,17.7,4,73,18.3,1,8.1,39,232,5.9,2,,kayron-adams-1
372,Marcel Murray,Arkansas State,Sun Belt,5,47,158,3.4,1,31.6,1,2,2.0,0,0.4,48,160,3.3,1,,marcel-murray-1
373,Marcel Dancy,California,Pac-12,4,31,156,5.0,0,39.0,9,68,7.6,0,17.0,40,224,5.6,0,,marcel-dancy-1
374,Charlie Brewer,Baylor,Big 12,9,107,154,1.4,4,17.1,0,0,,0,0.0,107,154,1.4,4,,charlie-brewer-1
375,Javy McDonald,Middle Tennessee State,CUSA,9,37,153,4.1,0,17.0,9,55,6.1,0,6.1,46,208,4.5,0,,javy-mcdonald-1
376,Chez Mellusi,Clemson,ACC,9,27,151,5.6,3,16.8,5,38,7.6,1,4.2,32,189,5.9,4,,chez-mellusi-1
377,Phil Jurkovec,Boston College,ACC,10,77,150,1.9,3,15.0,0,0,,0,0.0,77,150,1.9,3,,phil-jurkovec-1
378,Khalil Shakir,Boise State,MWC,7,17,148,8.7,0,21.1,52,719,13.8,6,102.7,69,867,12.6,6,,khalil-shakir-1
379,Chance Nolan,Oregon State,Pac-12,4,30,147,4.9,1,36.8,0,0,,0,0.0,30,147,4.9,1,,chance-nolan-1
380,Bryson Denley,Bowling Green,MAC,5,39,146,3.7,0,29.2,0,0,,0,0.0,39,146,3.7,0,,bryson-denley-1
381,Kadin Remsberg,Air Force,MWC,4,25,146,5.8,1,36.5,0,0,,0,0.0,25,146,5.8,1,,kadin-remsberg-1
382,Sam Howell,North Carolina,ACC,12,92,146,1.6,5,12.2,1,1,1.0,1,0.1,93,147,1.6,6,,sam-howell-1
383,Amauri Pesek-Hickson,Kansas,Big 12,4,40,145,3.6,0,36.3,2,10,5.0,0,2.5,42,155,3.7,0,,amauri-pesek-hickson-1
384,Chris Curry,LSU,SEC,9,45,145,3.2,0,16.1,1,10,10.0,0,1.1,46,155,3.4,0,,chris-curry-2
385,Jordan Mims,Fresno State,MWC,6,28,145,5.2,1,24.2,10,92,9.2,1,15.3,38,237,6.2,2,,jordan-mims-1
386,Kenny Pickett,Pitt,ACC,9,81,145,1.8,8,16.1,0,0,,0,0.0,81,145,1.8,8,,kenny-pickett-1
387,C.J. Jones,Western Kentucky,CUSA,7,21,144,6.9,2,20.6,0,0,,0,0.0,21,144,6.9,2,,cj-jones-10
388,Kamari Pleasant,Washington,Pac-12,4,34,144,4.2,3,36.0,8,66,8.3,0,16.5,42,210,5.0,3,,kamari-pleasant-1
389,Jordan Houston,North Carolina State,ACC,12,42,143,3.4,3,11.9,14,59,4.2,0,4.9,56,202,3.6,3,,jordan-houston-1
390,Jared Wilson,South Alabama,Sun Belt,11,44,142,3.2,1,12.9,4,19,4.8,0,1.7,48,161,3.4,1,,jared-wilson-1
391,Kyric McGowan,Northwestern,Big Ten,8,24,141,5.9,1,17.6,34,366,10.8,0,45.8,58,507,8.7,1,,kyric-mcgowan-1
392,Tim Baldwin Jr.,Indiana,Big Ten,4,22,141,6.4,0,35.3,0,0,,0,0.0,22,141,6.4,0,,tim-baldwin-jr-1
393,Troy Henderson,Liberty,Ind,4,32,141,4.4,0,35.3,0,0,,0,0.0,32,141,4.4,0,,troy-henderson-2
394,Tevaka Tuioti,New Mexico,MWC,2,19,140,7.4,1,70.0,0,0,,0,0.0,19,140,7.4,1,,tevaka-tuioti-1
395,Nick Tronti,Florida Atlantic,CUSA,9,70,139,2.0,2,15.4,0,0,,0,0.0,70,139,2.0,2,,nick-tronti-1
396,Darien Rencher,Clemson,ACC,12,24,137,5.7,1,11.4,2,15,7.5,0,1.3,26,152,5.8,1,,darien-rencher-1
397,Brandon Peters,Illinois,Big Ten,5,24,136,5.7,1,27.2,0,0,,0,0.0,24,136,5.7,1,,brandon-peters-1
398,Kalil Pimpleton,Central Michigan,MAC,6,16,134,8.4,3,22.3,26,277,10.7,2,46.2,42,411,9.8,5,,kalil-pimpleton-1
399,Trey Sanders,Alabama,SEC,4,30,134,4.5,0,33.5,1,-2,-2.0,0,-0.5,31,132,4.3,0,,trey-sanders-2
400,John Lovett,Baylor,Big 12,5,45,130,2.9,1,26.0,9,49,5.4,1,9.8,54,179,3.3,2,,john-lovett-1
401,B.J. Daniels,UTSA,CUSA,12,23,129,5.6,2,10.8,1,0,0.0,0,0.0,24,129,5.4,2,,bj-daniels-2
402,Tyler Vitt,Texas State,Sun Belt,7,37,129,3.5,1,18.4,0,0,,0,0.0,37,129,3.5,1,,tyler-vitt-1
403,Elija Robinson,Air Force,MWC,2,19,128,6.7,0,64.0,0,0,,0,0.0,19,128,6.7,0,,elija-robinson-1
404,Jack Colletto,Oregon State,Pac-12,7,15,128,8.5,2,18.3,0,0,,0,0.0,15,128,8.5,2,,jack-colletto-1
405,Shakif Seymour,Toledo,MAC,2,16,127,7.9,2,63.5,2,10,5.0,0,5.0,18,137,7.6,2,,shakif-seymour-1
406,Lowell Narcisse,UTSA,CUSA,4,32,126,3.9,0,31.5,0,0,,0,0.0,32,126,3.9,0,,lowell-narcisse-1
407,B.J. Baylor,Oregon State,Pac-12,7,27,124,4.6,1,17.7,5,30,6.0,0,4.3,32,154,4.8,1,,bj-baylor-1
408,Myles Price,Texas Tech,Big 12,9,12,124,10.3,1,13.8,29,305,10.5,1,33.9,41,429,10.5,2,,myles-price-1
409,Qualan Jones,Baylor,Big 12,7,34,124,3.6,0,17.7,14,57,4.1,0,8.1,48,181,3.8,0,,qualan-jones-1
410,Zach Charbonnet,Michigan,Big Ten,5,19,124,6.5,1,24.8,6,41,6.8,0,8.2,25,165,6.6,1,,zach-charbonnet-1
411,Jamauri Wakefield,Vanderbilt,SEC,4,38,123,3.2,0,30.8,5,16,3.2,0,4.0,43,139,3.2,0,,jamauri-wakefield-1
412,Patrick Garwo,Boston College,ACC,7,33,122,3.7,0,17.4,7,31,4.4,0,4.4,40,153,3.8,0,,patrick-garwo-1
413,Richard Newton,Washington,Pac-12,2,23,122,5.3,2,61.0,1,7,7.0,0,3.5,24,129,5.4,2,,richard-newton-1
414,Treyson Potts,Minnesota,Big Ten,5,19,121,6.4,1,24.2,4,20,5.0,0,4.0,23,141,6.1,1,,treyson-potts-1
415,Darius Pinnix,East Carolina,American,6,44,120,2.7,2,20.0,2,19,9.5,2,3.2,46,139,3.0,4,,darius-pinnix-1
416,Cade Barnard,Army,Ind,11,25,119,4.8,1,10.8,0,0,,0,0.0,25,119,4.8,1,,cade-barnard-1
417,Chandler Smith,Houston,American,8,25,119,4.8,0,14.9,3,29,9.7,0,3.6,28,148,5.3,0,,chandler-smith-1
418,Max Johnson,LSU,SEC,6,54,119,2.2,2,19.8,0,0,,0,0.0,54,119,2.2,2,,max-johnson-2
419,Lucious Stanley,UAB,CUSA,8,20,118,5.9,2,14.8,3,37,12.3,0,4.6,23,155,6.7,2,,lucious-stanley-1
420,Ty Brock,Central Michigan,MAC,5,25,118,4.7,2,23.6,1,34,34.0,0,6.8,26,152,5.8,2,,ty-brock-1
421,Jabari Small,Tennessee,SEC,10,26,117,4.5,0,11.7,4,24,6.0,0,2.4,30,141,4.7,0,,jabari-small-1
422,Mitchell Pryor,Vanderbilt,SEC,8,28,117,4.2,1,14.6,3,21,7.0,0,2.6,31,138,4.5,1,,mitchell-pryor-1
423,B.J. Emmons,Florida Atlantic,CUSA,4,37,116,3.1,1,29.0,3,14,4.7,0,3.5,40,130,3.3,1,,bj-emmons-1
424,Warren Bryan,Air Force,MWC,3,23,116,5.0,1,38.7,0,0,,0,0.0,23,116,5.0,1,,warren-bryan-1
425,Charles McClelland,Cincinnati,American,4,22,115,5.2,0,28.8,1,5,5.0,0,1.3,23,120,5.2,0,,charles-mcclelland-1
426,Ellis Merriweather,Massachusetts,Ind,4,42,115,2.7,0,28.8,1,4,4.0,0,1.0,43,119,2.8,0,,ellis-merriweather-1
427,Greg Garner,Louisiana Tech,CUSA,9,33,115,3.5,2,12.8,3,16,5.3,0,1.8,36,131,3.6,2,,greg-garner-1
428,Armani Rogers,Ohio,MAC,3,19,114,6.0,2,38.0,0,0,,0,0.0,19,114,6.0,2,,armani-rogers-1
429,Calvin Brownholtz,UTEP,CUSA,8,27,114,4.2,3,14.3,0,0,,0,0.0,27,114,4.2,3,,calvin-brownholtz-1
430,Re-al Mitchell,Temple,American,3,34,114,3.4,0,38.0,0,0,,0,0.0,34,114,3.4,0,,re-al-mitchell-1
431,Jake Bentley,Utah,Pac-12,5,34,113,3.3,1,22.6,0,0,,0,0.0,34,113,3.3,1,,jake-bentley-2
432,Justice Ellison,Wake Forest,ACC,8,30,113,3.8,1,14.1,1,3,3.0,0,0.4,31,116,3.7,1,,justice-ellison-1
433,Caullin Lacy,South Alabama,Sun Belt,11,20,112,5.6,0,10.2,11,98,8.9,0,8.9,31,210,6.8,0,,caullin-lacy-1
434,Kadyn Roach,Louisiana-Monroe,Sun Belt,10,18,112,6.2,1,11.2,7,45,6.4,1,4.5,25,157,6.3,2,,kadyn-roach-1
435,Matthew Murla,Air Force,MWC,6,23,112,4.9,4,18.7,0,0,,0,0.0,23,112,4.9,4,,matthew-murla-1
436,Isaiah Chavez,New Mexico,MWC,3,22,111,5.0,1,37.0,0,0,,0,0.0,22,111,5.0,1,,isaiah-chavez-1
437,Isaiah Phillips,Louisiana-Monroe,Sun Belt,10,35,110,3.1,0,11.0,15,79,5.3,0,7.9,50,189,3.8,0,,isaiah-phillips-1
438,Marcus McElroy,Colorado State,MWC,4,41,110,2.7,3,27.5,1,12,12.0,0,3.0,42,122,2.9,3,,marcus-mcelroy-1
439,Ryan Graham,Arkansas State,Sun Belt,8,28,110,3.9,1,13.8,1,20,20.0,0,2.5,29,130,4.5,1,,ryan-graham-2
440,Holton Ahlers,East Carolina,American,8,54,109,2.0,1,13.6,0,0,,0,0.0,54,109,2.0,1,,holton-ahlers-1
441,Joe Milton,Michigan,Big Ten,6,38,109,2.9,1,18.2,0,0,,0,0.0,38,109,2.9,1,,joe-milton-2
442,Daniyel Ngata,Arizona State,Pac-12,4,26,108,4.2,1,27.0,1,16,16.0,0,4.0,27,124,4.6,1,,daniyel-ngata-1
443,George Holani,Boise State,MWC,4,19,108,5.7,1,27.0,7,52,7.4,2,13.0,26,160,6.2,3,,george-holani-1
444,Trevon Raymore,Bowling Green,MAC,3,23,108,4.7,0,36.0,0,0,,0,0.0,23,108,4.7,0,,trevon-raymore-1
445,Bryson Carroll,New Mexico,MWC,7,25,107,4.3,0,15.3,9,79,8.8,0,11.3,34,186,5.5,0,,bryson-carroll-1
446,Trestan Ebner,Baylor,Big 12,9,50,107,2.1,1,11.9,26,299,11.5,3,33.2,76,406,5.3,4,,trestan-ebner-1
447,Artice Hobbs IV,Army,Ind,9,17,106,6.2,0,11.8,2,11,5.5,0,1.2,19,117,6.2,0,,artice-hobbs-iv-1
448,Noah Johnson,South Florida,American,6,41,106,2.6,3,17.7,0,0,,0,0.0,41,106,2.6,3,,noah-johnson-3
449,CJ Williams,Navy,American,7,17,105,6.2,0,15.0,8,80,10.0,1,11.4,25,185,7.4,1,,cj-williams-2
450,Kelan Walker,Houston,American,7,21,105,5.0,0,15.0,1,5,5.0,0,0.7,22,110,5.0,0,,kelan-walker-1
451,Shane Buechele,SMU,American,10,58,105,1.8,2,10.5,1,0,0.0,0,0.0,59,105,1.8,2,,shane-buechele-1
452,Anderson Castle,Appalachian State,Sun Belt,12,17,104,6.1,0,8.7,0,0,,0,0.0,17,104,6.1,0,,anderson-castle-1
453,Trey Lowe III,Southern Mississippi,CUSA,4,44,104,2.4,1,26.0,0,0,,0,0.0,44,104,2.4,1,,trey-lowe-iii-1
454,Henry Colombi,Texas Tech,Big 12,6,51,103,2.0,1,17.2,0,0,,0,0.0,51,103,2.0,1,,henry-colombi-1
455,Trae Hall,New Mexico,MWC,4,39,102,2.6,0,25.5,1,16,16.0,1,4.0,40,118,3.0,1,,trae-hall-1
456,Trey Bess III,Eastern Michigan,MAC,4,16,102,6.4,0,25.5,0,0,,0,0.0,16,102,6.4,0,,trey-bess-iii-1
457,Dominique Shoffner,Charlotte,CUSA,4,21,101,4.8,0,25.3,0,0,,0,0.0,21,101,4.8,0,,dominique-shoffner-1
458,Jordon Brookshire,San Diego State,MWC,3,45,101,2.2,0,33.7,0,0,,0,0.0,45,101,2.2,0,,jordon-brookshire-1
459,T.J. Hammonds,Arkansas,SEC,8,14,101,7.2,0,12.6,3,63,21.0,0,7.9,17,164,9.6,0,,tj-hammonds-1
460,Jordan Waters,Duke,ACC,11,16,100,6.3,2,9.1,1,-7,-7.0,0,-0.6,17,93,5.5,2,,jordan-waters-1
461,Levi Williams,Wyoming,MWC,6,56,100,1.8,6,16.7,0,0,,0,0.0,56,100,1.8,6,,levi-williams-1
462,Malik Knowles,Kansas State,Big 12,9,6,100,16.7,1,11.1,13,204,15.7,3,22.7,19,304,16.0,4,,malik-knowles-1
463,British Brooks,North Carolina,ACC,12,24,99,4.1,0,8.3,0,0,,0,0.0,24,99,4.1,0,,british-brooks-1
464,Chadarius Townsend,Texas Tech,Big 12,9,18,99,5.5,1,11.0,3,23,7.7,0,2.6,21,122,5.8,1,,chadarius-townsend-1
465,Dustin Fletcher,Northern Illinois,MAC,3,16,99,6.2,0,33.0,0,0,,0,0.0,16,99,6.2,0,,dustin-fletcher-1
466,Rashad Amos,South Carolina,SEC,3,18,99,5.5,0,33.0,3,13,4.3,0,4.3,21,112,5.3,0,,rashad-amos-1
467,Leonard Parker,South Florida,American,6,22,98,4.5,2,16.3,1,12,12.0,0,2.0,23,110,4.8,2,,leonard-parker-2
468,TaMerik Williams,SMU,American,10,13,98,7.5,2,9.8,3,5,1.7,0,0.5,16,103,6.4,2,,tamerik-williams-1
469,Aaron Young,Rutgers,Big Ten,9,35,96,2.7,1,10.7,23,100,4.3,0,11.1,58,196,3.4,1,,aaron-young-5
470,DK Billingsley,Troy,Sun Belt,9,27,96,3.6,1,10.7,3,23,7.7,0,2.6,30,119,4.0,1,,dk-billingsley-1
471,Miles Davis,BYU,Ind,4,15,96,6.4,2,24.0,4,43,10.8,0,10.8,19,139,7.3,2,,miles-davis-1
472,Sampson James,Indiana,Big Ten,6,32,96,3.0,0,16.0,1,9,9.0,0,1.5,33,105,3.2,0,,sampson-james-1
473,Chance Warren,Navy,American,10,29,95,3.3,3,9.5,6,94,15.7,0,9.4,35,189,5.4,3,,chance-warren-1
474,Darius Bracy,Central Michigan,MAC,5,15,95,6.3,0,19.0,0,0,,0,0.0,15,95,6.3,0,,darius-bracy-1
475,Israel Abanikanda,Pitt,ACC,7,28,95,3.4,1,13.6,2,11,5.5,1,1.6,30,106,3.5,2,,israel-abanikanda-1
476,Jalen Knox,Missouri,SEC,9,12,95,7.9,1,10.6,31,305,9.8,0,33.9,43,400,9.3,1,,jalen-knox-1
477,Jalen Knox,Missouri,SEC,9,12,95,7.9,1,10.6,31,305,9.8,0,33.9,43,400,9.3,1,,jalen-knox-2
478,Max Borghi,Washington State,Pac-12,2,10,95,9.5,1,47.5,1,7,7.0,0,3.5,11,102,9.3,1,,max-borghi-1
479,Will Plummer,Arizona,Pac-12,3,29,95,3.3,0,31.7,0,0,,0,0.0,29,95,3.3,0,,will-plummer-1
480,John Rhys Plumlee,Ole Miss,SEC,7,25,94,3.8,0,13.4,6,79,13.2,0,11.3,31,173,5.6,0,,john-rhys-plumlee-1
481,Chase Brice,Duke,ACC,11,91,93,1.0,1,8.5,0,0,,0,0.0,91,93,1.0,1,,chase-brice-1
482,Rocko Griffin,Vanderbilt,SEC,8,37,92,2.5,0,11.5,1,3,3.0,0,0.4,38,95,2.5,0,,rocko-griffin-1
483,Todd Centeio,Colorado State,MWC,3,25,92,3.7,0,30.7,0,0,,0,0.0,25,92,3.7,0,,todd-centeio-1
484,Zach Kahn,Miami (OH),MAC,3,18,92,5.1,2,30.7,2,5,2.5,0,1.7,20,97,4.9,2,,zach-kahn-1
485,Luke Doty,South Carolina,SEC,8,41,91,2.2,0,11.4,0,0,,0,0.0,41,91,2.2,0,,luke-doty-1
486,Elijah Collins,Michigan State,Big Ten,7,41,90,2.2,0,12.9,4,34,8.5,0,4.9,45,124,2.8,0,,elijah-collins-1
487,Avery Morrow,Nevada,MWC,9,14,89,6.4,1,9.9,4,13,3.3,0,1.4,18,102,5.7,1,,avery-morrow-1
488,Brady White,Memphis,American,11,63,88,1.4,2,8.0,1,7,7.0,0,0.6,64,95,1.5,2,,brady-white-1
489,Josh Williams,LSU,SEC,10,22,88,4.0,0,8.8,0,0,,0,0.0,22,88,4.0,0,,josh-williams-10
490,Terrance Dixon,Georgia State,Sun Belt,10,9,88,9.8,0,8.8,21,226,10.8,0,22.6,30,314,10.5,0,,terrance-dixon-1
491,Ari Broussard,Rice,CUSA,5,25,87,3.5,0,17.4,1,10,10.0,0,2.0,26,97,3.7,0,,ari-broussard-1
492,Cameron Young,Cincinnati,American,2,2,87,43.5,1,43.5,0,0,,0,0.0,2,87,43.5,1,,cameron-young-3
493,Dee Baker,Southern Mississippi,CUSA,9,18,87,4.8,0,9.7,2,5,2.5,0,0.6,20,92,4.6,0,,dee-baker-1
494,Mason Garcia,East Carolina,American,3,19,87,4.6,1,29.0,0,0,,0,0.0,19,87,4.6,1,,mason-garcia-1
495,Calvin Camp,Charlotte,CUSA,6,19,86,4.5,1,14.3,0,0,,0,0.0,19,86,4.5,1,,calvin-camp-1
496,Jalen White,Georgia Southern,Sun Belt,12,20,86,4.3,0,7.2,0,0,,0,0.0,20,86,4.3,0,,jalen-white-1
497,Peny Boone,Maryland,Big Ten,4,19,86,4.5,0,21.5,2,21,10.5,0,5.3,21,107,5.1,0,,peny-boone-1
498,Steele Chambers,Ohio State,Big Ten,5,9,86,9.6,0,17.2,0,0,,0,0.0,9,86,9.6,0,,steele-chambers-1
499,Victor Tucker,Charlotte,CUSA,6,8,86,10.8,0,14.3,30,400,13.3,2,66.7,38,486,12.8,2,,victor-tucker-1
500,Collin Schlee,Kent State,MAC,3,12,85,7.1,1,28.3,0,0,,0,0.0,12,85,7.1,1,,collin-schlee-1
501,Devin Brumfield,Utah,Pac-12,4,21,85,4.0,1,21.3,5,26,5.2,0,6.5,26,111,4.3,1,,devin-brumfield-1
502,Jovoni Johnson,Rice,CUSA,4,26,83,3.2,0,20.8,0,0,,0,0.0,26,83,3.2,0,,jovoni-johnson-1
503,Baden Pinson,Coastal Carolina,Sun Belt,12,13,82,6.3,1,6.8,2,22,11.0,0,1.8,15,104,6.9,1,,baden-pinson-1
504,Donny Marcus,Ball State,MAC,4,15,82,5.5,0,20.5,1,5,5.0,0,1.3,16,87,5.4,0,,donny-marcus-1
505,Fred Payton,Coastal Carolina,Sun Belt,9,15,82,5.5,0,9.1,0,0,,0,0.0,15,82,5.5,0,,fred-payton-1
506,Nykeim Johnson,Syracuse,ACC,11,8,82,10.3,0,7.5,20,323,16.2,4,29.4,28,405,14.5,4,,nykeim-johnson-1
507,Alex Escobar,New Mexico State,Ind,1,14,81,5.8,0,81.0,0,0,,0,0.0,14,81,5.8,0,,alex-escobar-1
508,Don Ragsdale,Southern Mississippi,CUSA,4,24,81,3.4,1,20.3,1,1,1.0,0,0.3,25,82,3.3,1,,don-ragsdale-1
509,Elelyon Noa,Utah State,MWC,6,31,81,2.6,0,13.5,3,15,5.0,0,2.5,34,96,2.8,0,,elelyon-noa-1
510,Mikey Henderson,Oklahoma,Big 12,9,9,81,9.0,1,9.0,12,168,14.0,1,18.7,21,249,11.9,2,,mikey-henderson-2
511,Ron Cook Jr.,Buffalo,MAC,7,20,81,4.1,0,11.6,1,15,15.0,0,2.1,21,96,4.6,0,,ron-cook-jr-1
512,John Chenal,Wisconsin,Big Ten,7,12,80,6.7,2,11.4,0,0,,0,0.0,12,80,6.7,2,,john-chenal-1
513,Jonah Johnson,New Mexico State,Ind,2,19,80,4.2,2,40.0,0,0,,0,0.0,19,80,4.2,2,,jonah-johnson-1
514,Lucas Johnson,San Diego State,MWC,3,8,80,10.0,1,26.7,0,0,,0,0.0,8,80,10.0,1,,lucas-johnson-2
515,Kaylan Wiggins,Florida International,CUSA,3,16,79,4.9,1,26.3,0,0,,0,0.0,16,79,4.9,1,,kaylan-wiggins-1
516,Larry McCammon III,Florida Atlantic,CUSA,2,17,79,4.6,0,39.5,2,9,4.5,0,4.5,19,88,4.6,0,,larry-mccammon-iii-1
517,Elijah Young,Missouri,SEC,7,10,78,7.8,0,11.1,0,0,,0,0.0,10,78,7.8,0,,elijah-young-1
518,Blake Corum,Michigan,Big Ten,6,26,77,3.0,2,12.8,5,73,14.6,0,12.2,31,150,4.8,2,,blake-corum-1
519,Brady McBride,Texas State,Sun Belt,9,64,76,1.2,0,8.4,0,0,,0,0.0,64,76,1.2,0,,brady-mcbride-1
520,Luke Zban,Marshall,CUSA,4,9,76,8.4,0,19.0,0,0,,0,0.0,9,76,8.4,0,,luke-zban-1
521,Mark-Antony Richards,Auburn,SEC,4,20,76,3.8,0,19.0,0,0,,0,0.0,20,76,3.8,0,,mark-antony-richards-1
522,Micah Bernard,Utah,Pac-12,5,15,76,5.1,0,15.2,4,25,6.3,0,5.0,19,101,5.3,0,,micah-bernard-1
523,AJ Howard Jr.,Army,Ind,12,15,75,5.0,0,6.3,1,6,6.0,0,0.5,16,81,5.1,0,,aj-howard-jr-1
524,Chase Garbers,California,Pac-12,4,39,75,1.9,2,18.8,0,0,,0,0.0,39,75,1.9,2,,chase-garbers-1
525,Frank Peasant,Middle Tennessee State,CUSA,9,18,75,4.2,1,8.3,3,2,0.7,0,0.2,21,77,3.7,1,,frank-peasant-1
526,Kobe Pace,Clemson,ACC,8,18,75,4.2,0,9.4,5,26,5.2,1,3.3,23,101,4.4,1,,kobe-pace-1
527,Treylon Burks,Arkansas,SEC,9,15,75,5.0,0,8.3,51,820,16.1,7,91.1,66,895,13.6,7,,treylon-burks-1
528,Tyjon Lindsey,Oregon State,Pac-12,6,10,75,7.5,0,12.5,11,159,14.5,3,26.5,21,234,11.1,3,,tyjon-lindsey-1
529,Charles Strong Jr.,Troy,Sun Belt,11,17,74,4.4,1,6.7,0,0,,0,0.0,17,74,4.4,1,,charles-strong-jr-1
530,Coran Taylor,Illinois,Big Ten,2,36,74,2.1,0,37.0,0,0,,0,0.0,36,74,2.1,0,,coran-taylor-1
531,Jordan McCloud,South Florida,American,8,62,74,1.2,1,9.3,1,18,18.0,0,2.3,63,92,1.5,1,,jordan-mccloud-1
532,Brendon Lewis,Colorado,Pac-12,1,9,73,8.1,1,73.0,0,0,,0,0.0,9,73,8.1,1,,brendon-lewis-1
533,Chris Evans,Michigan,Big Ten,6,16,73,4.6,1,12.2,9,87,9.7,0,14.5,25,160,6.4,1,,chris-evans-2
534,Keegan Jones,UCLA,Pac-12,5,15,73,4.9,1,14.6,3,31,10.3,1,6.2,18,104,5.8,2,,keegan-jones-1
535,Keon Howard,Tulane,American,6,15,73,4.9,1,12.2,0,0,,0,0.0,15,73,4.9,1,,keon-howard-1
536,Kevin Davis,Miami (OH),MAC,3,22,73,3.3,0,24.3,5,57,11.4,0,19.0,27,130,4.8,0,,kevin-davis-8
537,Daimarqua Foster,TCU,Big 12,5,22,72,3.3,1,14.4,7,48,6.9,0,9.6,29,120,4.1,1,,daimarqua-foster-1
538,Jawhar Jordan,Syracuse,ACC,3,29,72,2.5,0,24.0,5,34,6.8,0,11.3,34,106,3.1,0,,jawhar-jordan-1
539,Roydell Williams,Alabama,SEC,8,19,71,3.7,1,8.9,0,0,,0,0.0,19,71,3.7,1,,roydell-williams-2
540,Javin Myers,Louisiana-Monroe,Sun Belt,6,17,70,4.1,0,11.7,6,25,4.2,0,4.2,23,95,4.1,0,,javin-myers-1
541,Kenan Christon,USC,Pac-12,5,10,70,7.0,0,14.0,2,0,0.0,0,0.0,12,70,5.8,0,,kenan-christon-1
542,Terrell Bynum,Washington,Pac-12,3,5,70,14.0,0,23.3,8,130,16.3,0,43.3,13,200,15.4,0,,terrell-bynum-1
543,Bo Melton,Rutgers,Big Ten,9,6,69,11.5,2,7.7,47,638,13.6,6,70.9,53,707,13.3,8,,bo-melton-1
544,Danny Davis,Wisconsin,Big Ten,2,8,69,8.6,1,34.5,3,78,26.0,1,39.0,11,147,13.4,2,,danny-davis-5
545,Kavika Fonua,BYU,Ind,11,16,69,4.3,0,6.3,4,36,9.0,2,3.3,20,105,5.3,2,,kavika-fonua-1
546,Davion Johnson,Miami (OH),MAC,2,16,68,4.3,0,34.0,3,36,12.0,0,18.0,19,104,5.5,0,,davion-johnson-2
547,Ira Armstead,Virginia,ACC,4,10,68,6.8,1,17.0,1,5,5.0,0,1.3,11,73,6.6,1,,ira-armstead-1
548,Isaiah Johnson,North Texas,CUSA,6,17,68,4.0,1,11.3,1,6,6.0,0,1.0,18,74,4.1,1,,isaiah-johnson-10
549,Jason Shelley,Utah State,MWC,4,33,68,2.1,0,17.0,0,0,,0,0.0,33,68,2.1,0,,jason-shelley-2
550,Taye McWilliams,Baylor,Big 12,5,13,68,5.2,0,13.6,1,4,4.0,0,0.8,14,72,5.1,0,,taye-mcwilliams-1
551,Tyler Snead,East Carolina,American,9,3,68,22.7,1,7.6,53,524,9.9,5,58.2,56,592,10.6,6,,tyler-snead-1
552,Cameron Davis,Washington,Pac-12,4,15,67,4.5,0,16.8,5,26,5.2,0,6.5,20,93,4.7,0,,cameron-davis-3
553,Dax Milne,BYU,Ind,12,11,67,6.1,0,5.6,70,1188,17.0,8,99.0,81,1255,15.5,8,,dax-milne-1
554,Edward Saydee,Temple,American,7,19,67,3.5,0,9.6,0,0,,0,0.0,19,67,3.5,0,,edward-saydee-1
555,Garrett Wilson,Ohio State,Big Ten,8,2,67,33.5,0,8.4,43,723,16.8,6,90.4,45,790,17.6,6,,garrett-wilson-2
556,K.J. Jefferson,Arkansas,SEC,5,28,67,2.4,2,13.4,0,0,,0,0.0,28,67,2.4,2,,kj-jefferson-1
557,Quincy Patterson,Virginia Tech,ACC,3,15,67,4.5,1,22.3,0,0,,0,0.0,15,67,4.5,1,,quincy-patterson-1
558,Ronnie Walker Jr.,Virginia,ACC,4,23,66,2.9,0,16.5,0,0,,0,0.0,23,66,2.9,0,,ronnie-walker-jr-1
559,Timothy Taylor,Memphis,American,6,4,66,16.5,1,11.0,3,20,6.7,0,3.3,7,86,12.3,1,,timothy-taylor-1
560,Ben Bryant,Cincinnati,American,8,6,65,10.8,1,8.1,0,0,,0,0.0,6,65,10.8,1,,ben-bryant-1
561,Christopher Brooks,California,Pac-12,3,21,65,3.1,1,21.7,4,17,4.3,0,5.7,25,82,3.3,1,,christopher-brooks-1
562,Daevon Vigilant,New Mexico,MWC,4,15,65,4.3,0,16.3,5,11,2.2,0,2.8,20,76,3.8,0,,daevon-vigilant-1
563,Derius Davis,TCU,Big 12,9,7,65,9.3,0,7.2,15,209,13.9,1,23.2,22,274,12.5,1,,derius-davis-1
564,D.J. Jones,North Carolina,ACC,8,11,65,5.9,1,8.1,0,0,,0,0.0,11,65,5.9,1,,dj-jones-6
565,DJ Turner,Pitt,ACC,11,10,65,6.5,0,5.9,44,634,14.4,3,57.6,54,699,12.9,3,,dj-turner-1
566,Johnny Richardson,UCF,American,6,11,65,5.9,1,10.8,0,0,,0,0.0,11,65,5.9,1,,johnny-richardson-4
567,Keylon Stokes,Tulsa,American,9,13,65,5.0,0,7.2,46,644,14.0,3,71.6,59,709,12.0,3,,keylon-stokes-1
568,Elijah Moore,Ole Miss,SEC,8,14,64,4.6,0,8.0,86,1193,13.9,8,149.1,100,1257,12.6,8,AA,elijah-moore-1
569,King Doerue,Purdue,Big Ten,4,17,64,3.8,0,16.0,1,20,20.0,1,5.0,18,84,4.7,1,,king-doerue-1
570,Miyan Williams,Ohio State,Big Ten,4,10,64,6.4,0,16.0,0,0,,0,0.0,10,64,6.4,0,,miyan-williams-1
571,Onasis Neely,Temple,American,5,20,63,3.2,1,12.6,0,0,,0,0.0,20,63,3.2,1,,onasis-neely-1
572,Robert Burns,Miami (FL),ACC,8,16,63,3.9,0,7.9,2,26,13.0,0,3.3,18,89,4.9,0,,robert-burns-1
573,Robert Burns,Miami (FL),ACC,8,16,63,3.9,0,7.9,2,26,13.0,0,3.3,18,89,4.9,0,,robert-burns-2
574,Chase Hayden,East Carolina,American,3,16,62,3.9,0,20.7,1,31,31.0,0,10.3,17,93,5.5,0,,chase-hayden-1
575,Joey Gatewood,Kentucky,SEC,7,25,62,2.5,0,8.9,0,0,,0,0.0,25,62,2.5,0,,joey-gatewood-1
576,Jutahn McClain,Kentucky,SEC,11,16,62,3.9,0,5.6,0,0,,0,0.0,16,62,3.9,0,,jutahn-mcclain-1
577,Marvin Scott III,Nebraska,Big Ten,5,24,62,2.6,0,12.4,2,17,8.5,0,3.4,26,79,3.0,0,,marvin-scott-iii-1
578,Will Koch,Massachusetts,Ind,3,21,62,3.0,0,20.7,1,-5,-5.0,0,-1.7,22,57,2.6,0,,will-koch-1
579,Anthony Richardson,Florida,SEC,4,7,61,8.7,0,15.3,0,0,,0,0.0,7,61,8.7,0,,anthony-richardson-2
580,Dakereon Joyner,South Carolina,SEC,10,2,61,30.5,1,6.1,7,55,7.9,1,5.5,9,116,12.9,2,,dakereon-joyner-1
581,David Ellis,Indiana,Big Ten,5,16,61,3.8,0,12.2,11,137,12.5,1,27.4,27,198,7.3,1,,david-ellis-2
582,Isaiah Holiness,San Jose State,MWC,7,19,61,3.2,0,8.7,10,97,9.7,1,13.9,29,158,5.4,1,,isaiah-holiness-1
583,Isaiah Jacobs,Maryland,Big Ten,4,19,61,3.2,0,15.3,2,22,11.0,0,5.5,21,83,4.0,0,,isaiah-jacobs-1
584,Josh Henderson,North Carolina,ACC,12,18,61,3.4,0,5.1,3,10,3.3,0,0.8,21,71,3.4,0,,josh-henderson-2
585,Joshua Stoner,Air Force,MWC,5,11,61,5.5,0,12.2,0,0,,0,0.0,11,61,5.5,0,,joshua-stoner-1
586,Malik Murray,Georgia Southern,Sun Belt,13,3,61,20.3,0,4.7,21,260,12.4,1,20.0,24,321,13.4,1,,malik-murray-1
587,Michael Orphey Jr.,Louisiana,Sun Belt,4,4,61,15.3,1,15.3,1,2,2.0,0,0.5,5,63,12.6,1,,michael-orphey-jr-1
588,Travell Harris,Washington State,Pac-12,4,5,61,12.2,2,15.3,29,340,11.7,2,85.0,34,401,11.8,4,,travell-harris-1
589,D.J. Uiagalelei,Clemson,ACC,10,28,60,2.1,4,6.0,0,0,,0,0.0,28,60,2.1,4,,dj-uiagalelei-1
590,Emani Bailey,Louisiana,Sun Belt,5,10,60,6.0,0,12.0,0,0,,0,0.0,10,60,6.0,0,,emani-bailey-1
591,Luca Diamont,Duke,ACC,1,12,60,5.0,0,60.0,0,0,,0,0.0,12,60,5.0,0,,luca-diamont-1
592,Tre Turner,Virginia Tech,ACC,10,9,60,6.7,2,6.0,34,529,15.6,3,52.9,43,589,13.7,5,,tre-turner-2
593,Tyson Riley,Army,Ind,7,13,59,4.5,0,8.4,0,0,,0,0.0,13,59,4.5,0,,tyson-riley-1
594,Zaquandre White,South Carolina,SEC,9,16,59,3.7,0,6.6,2,-4,-2.0,0,-0.4,18,55,3.1,0,,zaquandre-white-1
595,Brett Gabbert,Miami (OH),MAC,3,7,58,8.3,0,19.3,0,0,,0,0.0,7,58,8.3,0,,brett-gabbert-1
596,Isaiah Neyor,Wyoming,MWC,6,1,58,58.0,0,9.7,8,248,31.0,0,41.3,9,306,34.0,0,,isaiah-neyor-1
597,Jordan Addison,Pitt,ACC,10,9,58,6.4,0,5.8,60,666,11.1,4,66.6,69,724,10.5,4,,jordan-addison-1
598,Kylin Hill,Mississippi State,SEC,3,15,58,3.9,0,19.3,23,237,10.3,1,79.0,38,295,7.8,1,,kylin-hill-1
599,Tre Bradford,LSU,SEC,5,10,58,5.8,0,11.6,3,13,4.3,1,2.6,13,71,5.5,1,,tre-bradford-1
600,Avery Davis,Notre Dame,ACC,12,3,57,19.0,0,4.8,24,322,13.4,2,26.8,27,379,14.0,2,,avery-davis-1
601,Chubba Purdy,Florida State,ACC,3,19,57,3.0,0,19.0,0,0,,0,0.0,19,57,3.0,0,,chubba-purdy-1
602,Colby Suits,Louisiana-Monroe,Sun Belt,8,35,57,1.6,0,7.1,0,0,,0,0.0,35,57,1.6,0,,colby-suits-1
603,Daniel Carter,Pitt,ACC,9,14,57,4.1,1,6.3,1,5,5.0,0,0.6,15,62,4.1,1,,daniel-carter-1
604,Dylan Morris,Washington,Pac-12,4,17,57,3.4,2,14.3,0,0,,0,0.0,17,57,3.4,2,,dylan-morris-1
605,Isaiah Azubuike,Arkansas State,Sun Belt,6,18,57,3.2,1,9.5,1,0,0.0,0,0.0,19,57,3.0,1,,isaiah-azubuike-1
606,O'Shaan Allison,Ohio,MAC,3,16,57,3.6,0,19.0,1,13,13.0,0,4.3,17,70,4.1,0,,oshaan-allison-1
607,Jackson McChesney,BYU,Ind,1,11,56,5.1,1,56.0,0,0,,0,0.0,11,56,5.1,1,,jackson-mcchesney-1
608,Kaedric Cobbs,UTSA,CUSA,11,11,56,5.1,1,5.1,0,0,,0,0.0,11,56,5.1,1,,kaedric-cobbs-1
609,Dawaiian McNeely,Wyoming,MWC,5,14,55,3.9,0,11.0,0,0,,0,0.0,14,55,3.9,0,,dawaiian-mcneely-1
610,Elijah Green,North Carolina,ACC,3,10,55,5.5,0,18.3,0,0,,0,0.0,10,55,5.5,0,,elijah-green-1
611,Michel Dukes,Clemson,ACC,7,8,55,6.9,0,7.9,0,0,,0,0.0,8,55,6.9,0,,michel-dukes-1
612,Tony Mathis,West Virginia,Big 12,6,18,55,3.1,1,9.2,0,0,,0,0.0,18,55,3.1,1,,tony-mathis-2
613,CJ McNeal,Air Force,MWC,3,5,54,10.8,0,18.0,0,0,,0,0.0,5,54,10.8,0,,cj-mcneal-1
614,Ihmir Smith-Marsette,Iowa,Big Ten,7,7,54,7.7,1,7.7,25,345,13.8,3,49.3,32,399,12.5,4,,ihmir-smith-marsette-1
615,Ivory Kelly-Martin,Iowa,Big Ten,7,13,54,4.2,0,7.7,3,22,7.3,0,3.1,16,76,4.8,0,,ivory-kelly-martin-1
616,Jordan Wilmore,Utah,Pac-12,2,18,54,3.0,0,27.0,0,0,,0,0.0,18,54,3.0,0,,jordan-wilmore-1
617,Kyle Dobbins,Temple,American,5,14,54,3.9,0,10.8,0,0,,0,0.0,14,54,3.9,0,,kyle-dobbins-1
618,Stetson Bennett,Georgia,SEC,8,24,54,2.3,2,6.8,0,0,,0,0.0,24,54,2.3,2,,stetson-bennett-1
619,Taye Barber,TCU,Big 12,10,15,54,3.6,0,5.4,31,318,10.3,2,31.8,46,372,8.1,2,,taye-barber-1
620,Todd Sibley Jr.,Pitt,ACC,6,13,54,4.2,1,9.0,1,7,7.0,0,1.2,14,61,4.4,1,,todd-sibley-jr-1
621,Treshaun Ward,Florida State,ACC,2,2,54,27.0,1,27.0,1,6,6.0,0,3.0,3,60,20.0,1,,treshaun-ward-1
622,Courtney Reese,Nevada-Las Vegas,MWC,6,9,53,5.9,0,8.8,7,40,5.7,0,6.7,16,93,5.8,0,,courtney-reese-1
623,Eli Peters,Toledo,MAC,4,25,53,2.1,0,13.3,0,0,,0,0.0,25,53,2.1,0,,eli-peters-1
624,Jaylon Redd,Oregon,Pac-12,7,3,53,17.7,1,7.6,25,281,11.2,1,40.1,28,334,11.9,2,,jaylon-redd-1
625,DeQuan Finn,Toledo,MAC,4,10,51,5.1,0,12.8,0,0,,0,0.0,10,51,5.1,0,,dequan-finn-1
626,Eli Stove,Auburn,SEC,10,7,51,7.3,0,5.1,44,359,8.2,3,35.9,51,410,8.0,3,,eli-stove-1
627,Larry Wooden,UAB,CUSA,6,17,51,3.0,0,8.5,1,-2,-2.0,0,-0.3,18,49,2.7,0,,larry-wooden-1
628,Brant Kuithe,Utah,Pac-12,5,6,50,8.3,0,10.0,25,236,9.4,0,47.2,31,286,9.2,0,,brant-kuithe-1
629,Emmanuel Logan-Greene,New Mexico,MWC,7,9,50,5.6,0,7.1,30,277,9.2,0,39.6,39,327,8.4,0,,emmanuel-logan-greene-1
630,Jermaine Burton,Georgia,SEC,10,4,50,12.5,0,5.0,27,404,15.0,3,40.4,31,454,14.6,3,,jermaine-burton-1
631,Jhaylin Embry,Bowling Green,MAC,3,6,50,8.3,0,16.7,0,0,,0,0.0,6,50,8.3,0,,jhaylin-embry-1
632,Jordan Whittington,Texas,Big 12,5,3,50,16.7,1,10.0,21,206,9.8,0,41.2,24,256,10.7,1,,jordan-whittington-2
633,Kyle Trask,Florida,SEC,12,64,50,0.8,3,4.2,0,0,,0,0.0,64,50,0.8,3,H-4,kyle-trask-1
634,Drew Plitt,Ball State,MAC,8,80,49,0.6,4,6.1,0,0,,0,0.0,80,49,0.6,4,,drew-plitt-1
635,Miller Mosley,Georgia Southern,Sun Belt,4,13,49,3.8,0,12.3,0,0,,0,0.0,13,49,3.8,0,,miller-mosley-1
636,Perry Carter,Louisiana-Monroe,Sun Belt,10,5,49,9.8,2,4.9,22,312,14.2,2,31.2,27,361,13.4,4,,perry-carter-2
637,Ryan Rehkow,BYU,Ind,12,1,49,49.0,0,4.1,0,0,,0,0.0,1,49,49.0,0,,ryan-rehkow-1
638,Chimere Dike,Wisconsin,Big Ten,7,6,48,8.0,0,6.9,12,189,15.8,1,27.0,18,237,13.2,1,,chimere-dike-1
639,C.J. Stroud,Ohio State,Big Ten,2,1,48,48.0,1,24.0,0,0,,0,0.0,1,48,48.0,1,,cj-stroud-1
640,Marcus Carroll,Georgia State,Sun Belt,8,17,48,2.8,2,6.0,0,0,,0,0.0,17,48,2.8,2,,marcus-carroll-1
641,Markenzy Pierre,Syracuse,ACC,11,21,48,2.3,0,4.4,1,2,2.0,0,0.2,22,50,2.3,0,,markenzy-pierre-1
642,Sione Finau,BYU,Ind,6,12,48,4.0,0,8.0,2,8,4.0,0,1.3,14,56,4.0,0,,sione-finau-1
643,Tayvion Robinson,Virginia Tech,ACC,11,5,48,9.6,0,4.4,38,592,15.6,3,53.8,43,640,14.9,3,,tayvion-robinson-1
644,Braydon Bennett,Coastal Carolina,Sun Belt,4,6,47,7.8,1,11.8,0,0,,0,0.0,6,47,7.8,1,,braydon-bennett-1
645,Chris Lovick,Tulsa,American,9,9,47,5.2,0,5.2,0,0,,0,0.0,9,47,5.2,0,,chris-lovick-1
646,Melquise Stovall,Hawaii,MWC,9,5,47,9.4,0,5.2,31,232,7.5,0,25.8,36,279,7.8,0,,melquise-stovall-1
647,Mohamed Sanogo,Ole Miss,SEC,10,1,47,47.0,0,4.7,0,0,,0,0.0,1,47,47.0,0,,mohamed-sanogo-1
648,Pailate Makakona,Utah State,MWC,6,10,47,4.7,0,7.8,2,12,6.0,0,2.0,12,59,4.9,0,,pailate-makakona-1
649,Payton Thorne,Michigan State,Big Ten,4,25,47,1.9,1,11.8,0,0,,0,0.0,25,47,1.9,1,,payton-thorne-1
650,Rondarius Gregory,Northern Illinois,MAC,2,10,47,4.7,0,23.5,1,0,0.0,0,0.0,11,47,4.3,0,,rondarius-gregory-1
651,Sean Dollars,Oregon,Pac-12,6,8,47,5.9,0,7.8,0,0,,0,0.0,8,47,5.9,0,,sean-dollars-1
652,Spence Massey,Georgia Tech,ACC,5,3,47,15.7,0,9.4,0,0,,0,0.0,3,47,15.7,0,,spence-massey-1
653,Wilson Catoe,Army,Ind,12,1,47,47.0,0,3.9,0,0,,0,0.0,1,47,47.0,0,,wilson-catoe-1
654,Dalen Morris,Navy,American,9,68,46,0.7,2,5.1,1,7,7.0,0,0.8,69,53,0.8,2,,dalen-morris-1
655,Dalen Morris,Navy,American,9,68,46,0.7,2,5.1,1,7,7.0,0,0.8,69,53,0.8,2,,dalen-morris-2
656,Jirehl Brock,Iowa State,Big 12,9,13,46,3.5,0,5.1,4,32,8.0,0,3.6,17,78,4.6,0,,jirehl-brock-1
657,Maurice Bellan,Army,Ind,7,13,46,3.5,0,6.6,0,0,,0,0.0,13,46,3.5,0,,maurice-bellan-1
658,AJ Phillips,South Alabama,Sun Belt,10,11,45,4.1,0,4.5,0,0,,0,0.0,11,45,4.1,0,,aj-phillips-1
659,Calvin Tyler Jr.,Oregon State,Pac-12,3,15,45,3.0,2,15.0,2,9,4.5,0,3.0,17,54,3.2,2,,calvin-tyler-jr-1
660,Jevon Bigelow,Fresno State,MWC,4,11,45,4.1,0,11.3,1,9,9.0,0,2.3,12,54,4.5,0,,jevon-bigelow-1
661,Mason Stokke,Wisconsin,Big Ten,7,19,45,2.4,1,6.4,8,58,7.3,3,8.3,27,103,3.8,4,,mason-stokke-1
662,Chandler Morris,Oklahoma,Big 12,5,5,44,8.8,2,8.8,0,0,,0,0.0,5,44,8.8,2,,chandler-morris-1
663,CJ Beasley,Coastal Carolina,Sun Belt,1,8,44,5.5,0,44.0,0,0,,0,0.0,8,44,5.5,0,,cj-beasley-1
664,Kelvin Dean Jr.,Florida Atlantic,CUSA,9,19,44,2.3,0,4.9,1,0,0.0,0,0.0,20,44,2.2,0,,kelvin-dean-jr-1
665,Tajay Ahmed,Buffalo,MAC,3,1,44,44.0,1,14.7,0,0,,0,0.0,1,44,44.0,1,,tajay-ahmed-1
666,Taulia Tagovailoa,Maryland,Big Ten,4,26,44,1.7,2,11.0,0,0,,0,0.0,26,44,1.7,2,,taulia-tagovailoa-1
667,Chavon McEachern,Charlotte,CUSA,3,11,43,3.9,1,14.3,0,0,,0,0.0,11,43,3.9,1,,chavon-mceachern-1
668,Chris Jackson,BYU,Ind,9,9,43,4.8,0,4.8,6,22,3.7,0,2.4,15,65,4.3,0,,chris-jackson-12
669,Haynes King,Texas A&M,SEC,2,6,43,7.2,0,21.5,0,0,,0,0.0,6,43,7.2,0,,haynes-king-1
670,Kawaan Baker,South Alabama,Sun Belt,11,13,42,3.2,0,3.8,51,659,12.9,8,59.9,64,701,11.0,8,,kawaan-baker-1
671,Brennon Dingle,UTSA,CUSA,12,5,41,8.2,0,3.4,27,266,9.9,2,22.2,32,307,9.6,2,,brennon-dingle-1
672,Brett Brenton,Wyoming,MWC,4,3,41,13.7,1,10.3,0,0,,0,0.0,3,41,13.7,1,,brett-brenton-1
673,Brian Maurer,Tennessee,SEC,4,5,41,8.2,0,10.3,0,0,,0,0.0,5,41,8.2,0,,brian-maurer-1
674,Carter Bradley,Toledo,MAC,4,18,41,2.3,0,10.3,0,0,,0,0.0,18,41,2.3,0,,carter-bradley-1
675,Jordan Merrell,Florida Atlantic,CUSA,9,4,41,10.3,0,4.6,18,218,12.1,0,24.2,22,259,11.8,0,,jordan-merrell-1
676,Kenny Tracy,Miami (OH),MAC,2,8,41,5.1,0,20.5,1,3,3.0,0,1.5,9,44,4.9,0,,kenny-tracy-1
677,Phillip Brooks,Kansas State,Big 12,10,8,41,5.1,0,4.1,15,155,10.3,2,15.5,23,196,8.5,2,,phillip-brooks-1
678,Ryan Montgomery,Cincinnati,American,10,15,41,2.7,0,4.1,4,16,4.0,0,1.6,19,57,3.0,0,,ryan-montgomery-1
679,Willie Wright,Florida Atlantic,CUSA,8,6,41,6.8,0,5.1,15,117,7.8,0,14.6,21,158,7.5,0,,willie-wright-4
680,Ygenio Booker,Tulane,American,5,9,41,4.6,0,8.2,1,-3,-3.0,0,-0.6,10,38,3.8,0,,ygenio-booker-1
681,Zay Flowers,Boston College,ACC,11,11,41,3.7,1,3.7,56,892,15.9,9,81.1,67,933,13.9,10,,zay-flowers-1
682,Anthony Brown,Oregon,Pac-12,2,7,40,5.7,2,20.0,0,0,,0,0.0,7,40,5.7,2,,anthony-brown-11
683,Chase Griffin,UCLA,Pac-12,4,18,40,2.2,0,10.0,0,0,,0,0.0,18,40,2.2,0,,chase-griffin-1
684,Garrett Greene,West Virginia,Big 12,2,6,40,6.7,0,20.0,0,0,,0,0.0,6,40,6.7,0,,garrett-greene-1
685,Kyle Philips,UCLA,Pac-12,7,4,40,10.0,0,5.7,38,370,9.7,2,52.9,42,410,9.8,2,,kyle-philips-4
686,Xavier Gaines,Marshall,CUSA,10,10,40,4.0,0,4.0,28,404,14.4,4,40.4,38,444,11.7,4,,xavier-gaines-2
687,Cade Fortin,South Florida,American,2,4,39,9.8,0,19.5,0,0,,0,0.0,4,39,9.8,0,,cade-fortin-1
688,Carlinos Acie,Navy,American,10,11,39,3.5,0,3.9,1,9,9.0,0,0.9,12,48,4.0,0,,carlinos-acie-1
689,Keyon Mozee,Kansas State,Big 12,9,11,39,3.5,0,4.3,2,83,41.5,0,9.2,13,122,9.4,0,,keyon-mozee-1
690,Matt McDonald,Bowling Green,MAC,5,27,39,1.4,1,7.8,0,0,,0,0.0,27,39,1.4,1,,matt-mcdonald-1
691,Noah Whittington,Western Kentucky,CUSA,12,16,39,2.4,0,3.3,3,5,1.7,0,0.4,19,44,2.3,0,,noah-whittington-1
692,Rocky Lombardi,Michigan State,Big Ten,6,32,39,1.2,0,6.5,0,0,,0,0.0,32,39,1.2,0,,rocky-lombardi-1
693,Thomas MacVittie,Kansas,Big 12,2,8,39,4.9,0,19.5,0,0,,0,0.0,8,39,4.9,0,,thomas-macvittie-1
694,Braheam Murphy,Army,Ind,10,7,38,5.4,1,3.8,0,0,,0,0.0,7,38,5.4,1,,braheam-murphy-1
695,Charlie Jones,Iowa,Big Ten,8,2,38,19.0,0,4.8,0,0,,0,0.0,2,38,19.0,0,,charlie-jones-7
696,Danny Smith,Boise State,MWC,2,12,38,3.2,0,19.0,0,0,,0,0.0,12,38,3.2,0,,danny-smith-5
697,Graham Mertz,Wisconsin,Big Ten,7,36,38,1.1,2,5.4,0,0,,0,0.0,36,38,1.1,2,,graham-mertz-1
698,Jack Sears,Boise State,MWC,3,9,38,4.2,1,12.7,0,0,,0,0.0,9,38,4.2,1,,jack-sears-1
699,James Fullbright III,Houston,American,3,4,38,9.5,1,12.7,0,0,,0,0.0,4,38,9.5,1,,james-fullbright-iii-1
700,Kaleb Eleby,Western Michigan,MAC,6,34,38,1.1,4,6.3,0,0,,0,0.0,34,38,1.1,4,,kaleb-eleby-1
701,Kyle Vantrease,Buffalo,MAC,7,11,38,3.5,4,5.4,0,0,,0,0.0,11,38,3.5,4,,kyle-vantrease-1
702,Lawrence Papillon,Marshall,CUSA,6,10,38,3.8,1,6.3,0,0,,0,0.0,10,38,3.8,1,,lawrence-papillon-1
703,Skylar Thompson,Kansas State,Big 12,3,19,38,2.0,3,12.7,0,0,,0,0.0,19,38,2.0,3,,skylar-thompson-1
704,Christian Hunter,Colorado State,MWC,2,8,37,4.6,0,18.5,0,0,,0,0.0,8,37,4.6,0,,christian-hunter-1
705,Davis Mills,Stanford,Pac-12,5,30,37,1.2,3,7.4,0,0,,0,0.0,30,37,1.2,3,,davis-mills-1
706,Doug Brumfield,Nevada-Las Vegas,MWC,2,14,37,2.6,1,18.5,0,0,,0,0.0,14,37,2.6,1,,doug-brumfield-1
707,Jack Tuttle,Indiana,Big Ten,3,15,37,2.5,0,12.3,0,0,,0,0.0,15,37,2.5,0,,jack-tuttle-1
708,Joachim Bangda,Kent State,MAC,3,6,37,6.2,0,12.3,0,0,,0,0.0,6,37,6.2,0,,joachim-bangda-1
709,Caron Robinson,Buffalo,MAC,1,5,36,7.2,0,36.0,0,0,,0,0.0,5,36,7.2,0,,caron-robinson-1
710,Chris Reynolds,Charlotte,CUSA,6,50,36,0.7,0,6.0,1,18,18.0,1,3.0,51,54,1.1,1,,chris-reynolds-1
711,Cyrus Habibi-Likio,Oregon,Pac-12,7,19,36,1.9,4,5.1,5,66,13.2,0,9.4,24,102,4.3,4,,cyrus-habibi-likio-1
712,Dante Wright,Colorado State,MWC,3,9,36,4.0,0,12.0,20,315,15.8,0,105.0,29,351,12.1,0,,dante-wright-1
713,Isaac Guerendo,Wisconsin,Big Ten,2,11,36,3.3,0,18.0,0,0,,0,0.0,11,36,3.3,0,,isaac-guerendo-1
714,Jesse Brown,Northwestern,Big Ten,6,15,36,2.4,2,6.0,3,29,9.7,0,4.8,18,65,3.6,2,,jesse-brown-3
715,Jsi Hatfield,East Carolina,American,6,4,36,9.0,0,6.0,6,31,5.2,0,5.2,10,67,6.7,0,,jsi-hatfield-1
716,Riley Smith,Boise State,MWC,7,4,36,9.0,0,5.1,15,155,10.3,1,22.1,19,191,10.1,1,,riley-smith-2
717,Tate Whatley,Southern Mississippi,CUSA,4,19,36,1.9,4,9.0,1,-19,-19.0,0,-4.8,20,17,0.9,4,,tate-whatley-1
718,Tyler Burns,Kansas State,Big 12,9,13,36,2.8,0,4.0,2,7,3.5,0,0.8,15,43,2.9,0,,tyler-burns-1
719,De'Vion Warren,Arkansas,SEC,7,4,35,8.8,0,5.0,15,278,18.5,3,39.7,19,313,16.5,3,,devion-warren-1
720,Jaren Mangham,Colorado,Pac-12,4,23,35,1.5,2,8.8,1,10,10.0,0,2.5,24,45,1.9,2,,jaren-mangham-1
721,Joseph Bruno,Penn State,Big Ten,7,3,35,11.7,0,5.0,0,0,,0,0.0,3,35,11.7,0,,joseph-bruno-1
722,Lee Witherspoon,Mississippi State,SEC,11,6,35,5.8,0,3.2,9,49,5.4,0,4.5,15,84,5.6,0,,lee-witherspoon-1
723,Micah Cooper,Oklahoma State,Big 12,2,7,35,5.0,0,17.5,0,0,,0,0.0,7,35,5.0,0,,micah-cooper-1
724,Blake Hayes,Illinois,Big Ten,8,2,34,17.0,0,4.3,0,0,,0,0.0,2,34,17.0,0,,blake-hayes-1
725,Gabriel Watson,Texas,Big 12,3,7,34,4.9,0,11.3,0,0,,0,0.0,7,34,4.9,0,,gabriel-watson-2
726,Jayden De Laura,Washington State,Pac-12,4,28,34,1.2,2,8.5,0,0,,0,0.0,28,34,1.2,2,,jayden-de-laura-1
727,Joe Davis,Colorado,Pac-12,6,18,34,1.9,0,5.7,1,4,4.0,0,0.7,19,38,2.0,0,,joe-davis-7
728,LaJohntay Wester,Florida Atlantic,CUSA,9,8,34,4.3,0,3.8,17,114,6.7,1,12.7,25,148,5.9,1,,lajohntay-wester-1
729,TJ Finley,LSU,SEC,5,29,34,1.2,1,6.8,0,0,,0,0.0,29,34,1.2,1,,tj-finley-1
730,Tyler Johnston III,UAB,CUSA,5,14,34,2.4,0,6.8,0,0,,0,0.0,14,34,2.4,0,,tyler-johnston-iii-1
731,Garret Kahmann,Louisiana-Monroe,Sun Belt,2,8,33,4.1,0,16.5,0,0,,0,0.0,8,33,4.1,0,,garret-kahmann-1
732,Garrett Kahmann,Louisiana-Monroe,Sun Belt,2,8,33,4.1,0,16.5,0,0,,0,0.0,8,33,4.1,0,,garrett-kahmann-1
733,John Gentry,Utah State,MWC,5,7,33,4.7,0,6.6,1,-4,-4.0,0,-0.8,8,29,3.6,0,,john-gentry-1
734,Ricky Pearsall,Arizona State,Pac-12,4,3,33,11.0,1,8.3,6,86,14.3,1,21.5,9,119,13.2,2,,ricky-pearsall-1
735,Chris Moore,Georgia State,Sun Belt,10,1,32,32.0,0,3.2,0,0,,0,0.0,1,32,32.0,0,,chris-moore-6
736,Daniel Bangura,Kent State,MAC,2,6,32,5.3,0,16.0,0,0,,0,0.0,6,32,5.3,0,,daniel-bangura-1
737,Demarkcus Bowman,Clemson,ACC,2,9,32,3.6,0,16.0,0,0,,0,0.0,9,32,3.6,0,,demarkcus-bowman-1
738,Josiah Johnson,Massachusetts,Ind,4,12,32,2.7,0,8.0,3,48,16.0,0,12.0,15,80,5.3,0,,josiah-johnson-1
739,Lorenzo Lingard,Florida,SEC,9,5,32,6.4,0,3.6,0,0,,0,0.0,5,32,6.4,0,,lorenzo-lingard-1
740,Ontaria Wilson,Florida State,ACC,9,4,32,8.0,0,3.6,30,382,12.7,2,42.4,34,414,12.2,2,,ontaria-wilson-1
741,Rondale Moore,Purdue,Big Ten,3,6,32,5.3,1,10.7,35,270,7.7,0,90.0,41,302,7.4,1,,rondale-moore-1
742,Tyetus Smith-Lindsay,UAB,CUSA,1,1,32,32.0,0,32.0,0,0,,0,0.0,1,32,32.0,0,,tyetus-smith-lindsay-1
743,Tyetus Smith-Lindsey,UAB,CUSA,1,1,32,32.0,0,32.0,0,0,,0,0.0,1,32,32.0,0,,tyetus-smith-lindsey-1
744,Casey Thompson,Texas,Big 12,3,8,31,3.9,0,10.3,0,0,,0,0.0,8,31,3.9,0,,casey-thompson-1
745,Jha'Quan Jackson,Tulane,American,12,2,31,15.5,1,2.6,31,425,13.7,8,35.4,33,456,13.8,9,,jhaquan-jackson-1
746,Mike Fallon,Massachusetts,Ind,1,4,31,7.8,0,31.0,0,0,,0,0.0,4,31,7.8,0,,mike-fallon-2
747,Shaadie Clayton-Johnson,Colorado,Pac-12,3,7,31,4.4,2,10.3,0,0,,0,0.0,7,31,4.4,2,,shaadie-clayton-1
748,Tabarious Peterson,Louisville,ACC,9,1,31,31.0,0,3.4,0,0,,0,0.0,1,31,31.0,0,,tabarious-peterson-1
749,Tyger Goslin,Navy,American,4,24,31,1.3,0,7.8,0,0,,0,0.0,24,31,1.3,0,,tyger-goslin-1
750,Danny Gray,SMU,American,8,3,30,10.0,2,3.8,33,448,13.6,4,56.0,36,478,13.3,6,,danny-gray-1
751,Jalen John,Arizona,Pac-12,2,4,30,7.5,0,15.0,3,24,8.0,0,12.0,7,54,7.7,0,,jalen-john-6
752,Jonzell Norrils,Akron,MAC,2,7,30,4.3,1,15.0,2,32,16.0,0,16.0,9,62,6.9,1,,jonzell-norrils-1
753,Jordan Griffin,Louisiana,Sun Belt,1,7,30,4.3,0,30.0,0,0,,0,0.0,7,30,4.3,0,,jordan-griffin-3
754,Lexington Joseph,Florida International,CUSA,3,8,30,3.8,0,10.0,2,7,3.5,0,2.3,10,37,3.7,0,,lexington-joseph-1
755,Quadry Jones,UCF,American,2,3,30,10.0,0,15.0,0,0,,0,0.0,3,30,10.0,0,,quadry-jones-1
756,Rahmir Johnson,Nebraska,Big Ten,6,8,30,3.8,1,5.0,6,33,5.5,0,5.5,14,63,4.5,1,,rahmir-johnson-1
757,Smoke Harris,Louisiana Tech,CUSA,8,5,30,6.0,1,3.8,39,304,7.8,4,38.0,44,334,7.6,5,,smoke-harris-1
758,Austin Aune,North Texas,CUSA,8,27,29,1.1,2,3.6,0,0,,0,0.0,27,29,1.1,2,,austin-aune-1
759,Bo Gross,Air Force,MWC,4,9,29,3.2,1,7.3,0,0,,0,0.0,9,29,3.2,1,,bo-gross-1
760,Iverson Clement,Florida,SEC,5,5,29,5.8,0,5.8,0,0,,0,0.0,5,29,5.8,0,,iverson-clement-1
761,Joel Dublanko,Cincinnati,American,10,1,29,29.0,0,2.9,0,0,,0,0.0,1,29,29.0,0,,joel-dublanko-1
762,Justin Ibieta,Tulane,American,2,3,29,9.7,0,14.5,0,0,,0,0.0,3,29,9.7,0,,justin-ibieta-1
763,Kevaris Thomas,Western Kentucky,CUSA,3,24,29,1.2,1,9.7,0,0,,0,0.0,24,29,1.2,1,,kevaris-thomas-1
764,Omarion Dollison,South Florida,American,9,2,29,14.5,0,3.2,21,272,13.0,1,30.2,23,301,13.1,1,,omarion-dollison-1
765,Reikan Donaldson,Army,Ind,10,1,29,29.0,0,2.9,4,57,14.3,1,5.7,5,86,17.2,1,,reikan-donaldson-1
766,Aveon Smith,Miami (OH),MAC,1,3,28,9.3,0,28.0,0,0,,0,0.0,3,28,9.3,0,,aveon-smith-1
767,Gavin Williams,Iowa,Big Ten,1,8,28,3.5,0,28.0,0,0,,0,0.0,8,28,3.5,0,,gavin-williams-1
768,Isiah Cox,Ohio,MAC,3,1,28,28.0,0,9.3,7,142,20.3,1,47.3,8,170,21.3,1,,isiah-cox-1
769,JD Spielman,TCU,Big 12,3,4,28,7.0,0,9.3,5,56,11.2,0,18.7,9,84,9.3,0,,jd-spielman-1
770,Josh Edwards,Arkansas State,Sun Belt,3,6,28,4.7,0,9.3,0,0,,0,0.0,6,28,4.7,0,,josh-edwards-1
771,Kadari Johnson,UTSA,CUSA,1,2,28,14.0,0,28.0,0,0,,0,0.0,2,28,14.0,0,,kadari-johnson-1
772,Reynaldo Flores,UTEP,CUSA,7,4,28,7.0,0,4.0,1,10,10.0,0,1.4,5,38,7.6,0,,reynaldo-flores-1
773,D'Wayne Eskridge,Western Michigan,MAC,6,1,27,27.0,0,4.5,34,784,23.1,8,130.7,35,811,23.2,8,,dwayne-eskridge-1
774,Gavin Beerup,Wyoming,MWC,2,5,27,5.4,0,13.5,0,0,,0,0.0,5,27,5.4,0,,gavin-beerup-1
775,Harlan Dixon,Louisiana Tech,CUSA,8,9,27,3.0,0,3.4,3,16,5.3,0,2.0,12,43,3.6,0,,harlan-dixon-1
776,Jalen Cropper,Fresno State,MWC,6,4,27,6.8,0,4.5,37,520,14.1,5,86.7,41,547,13.3,5,,jalen-cropper-1
777,Tyrice Richie,Northern Illinois,MAC,6,6,27,4.5,0,4.5,53,597,11.3,4,99.5,59,624,10.6,4,,tyrice-richie-1
778,Anthony Russo,Temple,American,4,22,26,1.2,2,6.5,0,0,,0,0.0,22,26,1.2,2,,anthony-russo-3
779,Aron Cruickshank,Rutgers,Big Ten,9,4,26,6.5,0,2.9,37,239,6.5,1,26.6,41,265,6.5,1,,aron-cruickshank-1
780,Chase Jasmin,San Diego State,MWC,1,5,26,5.2,0,26.0,0,0,,0,0.0,5,26,5.2,0,,chase-jasmin-1
781,Jack Abraham,Southern Mississippi,CUSA,5,29,26,0.9,0,5.2,0,0,,0,0.0,29,26,0.9,0,,jack-abraham-1
782,Jacolby Criswell,North Carolina,ACC,6,9,26,2.9,0,4.3,0,0,,0,0.0,9,26,2.9,0,,jacolby-criswell-1
783,Tayon Fleet-Davis,Maryland,Big Ten,1,10,26,2.6,0,26.0,1,17,17.0,0,17.0,11,43,3.9,0,,tayon-fleet-davis-1
784,Weston Eget,New Mexico State,Ind,1,5,26,5.2,0,26.0,0,0,,0,0.0,5,26,5.2,0,,weston-eget-1
785,Darrian Felix,South Florida,American,3,10,25,2.5,0,8.3,3,14,4.7,0,4.7,13,39,3.0,0,,darrian-felix-1
786,Dee Beckwith,Tennessee,SEC,3,3,25,8.3,0,8.3,0,0,,0,0.0,3,25,8.3,0,,dee-beckwith-1
787,Jojo Dorceus,Memphis,American,11,1,25,25.0,0,2.3,1,2,2.0,1,0.2,2,27,13.5,1,,jojo-dorceus-1
788,Joseph Dorceus,Memphis,American,9,1,25,25.0,0,2.8,1,2,2.0,1,0.2,2,27,13.5,1,,joseph-dorceus-1
789,Lindell Stone,Virginia,ACC,6,8,25,3.1,0,4.2,1,-3,-3.0,0,-0.5,9,22,2.4,0,,lindell-stone-1
790,Logan Bonner,Arkansas State,Sun Belt,11,34,25,0.7,0,2.3,1,17,17.0,0,1.5,35,42,1.2,0,,logan-bonner-1
791,Luke Larsen,East Carolina,American,5,1,25,25.0,0,5.0,0,0,,0,0.0,1,25,25.0,0,,luke-larsen-1
792,Michael Penix Jr.,Indiana,Big Ten,6,18,25,1.4,2,4.2,0,-13,,0,-2.2,18,12,0.7,2,,michael-penix-jr-1
793,Perry Olsen,Navy,American,1,10,25,2.5,0,25.0,0,0,,0,0.0,10,25,2.5,0,,perry-olsen-1
794,Taisun Phommachanh,Clemson,ACC,4,7,25,3.6,0,6.3,0,0,,0,0.0,7,25,3.6,0,,taisun-phommachanh-1
795,Trae Allen,Western Michigan,MAC,2,9,25,2.8,0,12.5,0,0,,0,0.0,9,25,2.8,0,,trae-allen-1
796,Tre Tucker,Cincinnati,American,10,4,25,6.3,0,2.5,18,236,13.1,3,23.6,22,261,11.9,3,,tre-tucker-1
797,Tyson Mobley,Coastal Carolina,Sun Belt,5,2,25,12.5,0,5.0,2,9,4.5,0,1.8,4,34,8.5,0,,tyson-mobley-1
798,Andrew Marty,Northwestern,Big Ten,4,5,24,4.8,0,6.0,1,12,12.0,0,3.0,6,36,6.0,0,,andrew-marty-1
799,Chase Jones,Western Kentucky,CUSA,2,4,24,6.0,1,12.0,0,0,,0,0.0,4,24,6.0,1,,chase-jones-3
800,Damarius Good,UCF,American,10,4,24,6.0,0,2.4,2,22,11.0,0,2.2,6,46,7.7,0,,damarius-good-1
801,Jacquez Stuart,Toledo,MAC,4,3,24,8.0,0,6.0,0,0,,0,0.0,3,24,8.0,0,,jacquez-stuart-1
802,Jay Warren,Navy,American,10,1,24,24.0,0,2.4,0,0,,0,0.0,1,24,24.0,0,,jay-warren-2
803,John Tank Miller,South Alabama,Sun Belt,5,5,24,4.8,0,4.8,0,0,,0,0.0,5,24,4.8,0,,john-tank-miller-1
804,Knox Kadum,Virginia Tech,ACC,1,6,24,4.0,0,24.0,0,0,,0,0.0,6,24,4.0,0,,knox-kadum-1
805,Ronald Thompkins,Nebraska,Big Ten,2,5,24,4.8,0,12.0,1,10,10.0,0,5.0,6,34,5.7,0,,ronald-thompkins-1
806,Isaiah Connelly,Coastal Carolina,Sun Belt,1,6,23,3.8,0,23.0,0,0,,0,0.0,6,23,3.8,0,,isaiah-connelly-1
807,Jack Miller III,Ohio State,Big Ten,2,2,23,11.5,1,11.5,0,0,,0,0.0,2,23,11.5,1,,jack-miller-iii-1
808,Jeremiah Haydel,Texas State,Sun Belt,12,3,23,7.7,0,1.9,40,408,10.2,4,34.0,43,431,10.0,4,,jeremiah-haydel-1
809,Jordan Watkins,Louisville,ACC,8,1,23,23.0,1,2.9,8,57,7.1,0,7.1,9,80,8.9,1,,jordan-watkins-2
810,Micaleous Elder,Charlotte,CUSA,6,8,23,2.9,2,3.8,22,264,12.0,2,44.0,30,287,9.6,4,,micaleous-elder-1
811,Tommy Devito,Syracuse,ACC,4,43,23,0.5,0,5.8,0,0,,0,0.0,43,23,0.5,0,,tommy-devito-1
812,Billy Kemp,Virginia,ACC,10,6,22,3.7,0,2.2,67,644,9.6,1,64.4,73,666,9.1,1,,billy-kemp-2
813,Brandon Walters,Army,Ind,12,5,22,4.4,0,1.8,5,33,6.6,0,2.8,10,55,5.5,0,,brandon-walters-1
814,Charleston Rambo,Oklahoma,Big 12,10,2,22,11.0,0,2.2,25,312,12.5,3,31.2,27,334,12.4,3,,charleston-rambo-1
815,Dennis Grosel,Boston College,ACC,3,7,22,3.1,0,7.3,0,0,,0,0.0,7,22,3.1,0,,dennis-grosel-1
816,DJ England-Chisolm,Middle Tennessee State,CUSA,9,6,22,3.7,0,2.4,14,172,12.3,2,19.1,20,194,9.7,2,,dj-england-chisolm-1
817,Grant Gunnell,Arizona,Pac-12,4,23,22,1.0,0,5.5,0,0,,0,0.0,23,22,1.0,0,,grant-gunnell-1
818,Jack Westover,Washington,Pac-12,4,5,22,4.4,0,5.5,1,9,9.0,0,2.3,6,31,5.2,0,,jack-westover-1
819,Khaleb Hood,Georgia Southern,Sun Belt,13,4,22,5.5,0,1.7,15,224,14.9,2,17.2,19,246,12.9,2,,khaleb-hood-1
820,Lachlan Wilson,Tulsa,American,9,1,22,22.0,0,2.4,0,0,,0,0.0,1,22,22.0,0,,lachlan-wilson-1
821,Malik Staples,Western Kentucky,CUSA,11,7,22,3.1,1,2.0,0,0,,0,0.0,7,22,3.1,1,,malik-staples-1
822,Rasheen Ali,Marshall,CUSA,6,5,22,4.4,0,3.7,0,0,,0,0.0,5,22,4.4,0,,rasheen-ali-1
823,Tyrone Tracy Jr.,Iowa,Big Ten,8,2,22,11.0,0,2.8,14,154,11.0,1,19.3,16,176,11.0,1,,tyrone-tracy-jr-1
824,Anthony Watkins,Tulsa,American,8,7,21,3.0,0,2.6,0,0,,0,0.0,7,21,3.0,0,,anthony-watkins-3
825,Baylor Romney,BYU,Ind,7,7,21,3.0,0,3.0,0,0,,0,0.0,7,21,3.0,0,,baylor-romney-1
826,Brannon Spector,Clemson,ACC,11,2,21,10.5,0,1.9,16,136,8.5,0,12.4,18,157,8.7,0,,brannon-spector-1
827,Cam Roberson,Massachusetts,Ind,4,11,21,1.9,0,5.3,1,10,10.0,0,2.5,12,31,2.6,0,,cam-roberson-1
828,Dazz Newsome,North Carolina,ACC,12,2,21,10.5,1,1.8,54,684,12.7,6,57.0,56,705,12.6,7,,dazz-newsome-1
829,Jack Plummer,Purdue,Big Ten,3,16,21,1.3,1,7.0,0,0,,0,0.0,16,21,1.3,1,,jack-plummer-1
830,James Graham,Georgia Tech,ACC,2,6,21,3.5,0,10.5,0,0,,0,0.0,6,21,3.5,0,,james-graham-1
831,Jay Bramblett,Notre Dame,ACC,12,2,21,10.5,0,1.8,0,0,,0,0.0,2,21,10.5,0,,jay-bramblett-1
832,Travis Tisdale,Kentucky,SEC,7,6,21,3.5,0,3.0,0,0,,0,0.0,6,21,3.5,0,,travis-tisdale-1
833,Cade Ballard,Army,Ind,3,9,20,2.2,1,6.7,0,0,,0,0.0,9,20,2.2,1,,cade-ballard-1
834,Cade Fennegan,Boise State,MWC,3,9,20,2.2,0,6.7,0,0,,0,0.0,9,20,2.2,0,,cade-fennegan-1
835,Chabastin Taylor,Kansas State,Big 12,10,1,20,20.0,0,2.0,19,293,15.4,1,29.3,20,313,15.7,1,,chabastin-taylor-1
836,Connor Bazelak,Missouri,SEC,10,44,20,0.5,2,2.0,0,0,,0,0.0,44,20,0.5,2,,connor-bazelak-1
837,Eli Pancol,Duke,ACC,11,4,20,5.0,1,1.8,24,241,10.0,1,21.9,28,261,9.3,2,,eli-pancol-1
838,Jack Lindsey,Arkansas,SEC,5,1,20,20.0,0,4.0,0,0,,0,0.0,1,20,20.0,0,,jack-lindsey-1
839,Jalon Daniels,Kansas,Big 12,7,73,20,0.3,3,2.9,0,0,,0,0.0,73,20,0.3,3,,jalon-daniels-1
840,J.C. Santana,Tulsa,American,9,2,20,10.0,0,2.2,34,544,16.0,4,60.4,36,564,15.7,4,,jc-santana-1
841,Maleek Williams,Florida International,CUSA,3,5,20,4.0,0,6.7,1,2,2.0,0,0.7,6,22,3.7,0,,maleek-williams-1
842,Rodney Thompson,Northern Illinois,MAC,2,6,20,3.3,1,10.0,0,0,,0,0.0,6,20,3.3,1,,rodney-thompson-2
843,Todd Hudson,Oklahoma,Big 12,2,8,20,2.5,0,10.0,0,0,,0,0.0,8,20,2.5,0,,todd-hudson-1
844,Tyler Crowe,Boise State,MWC,6,5,20,4.0,0,3.3,1,15,15.0,0,2.5,6,35,5.8,0,,tyler-crowe-1
845,Tyler Scott,Cincinnati,American,10,1,20,20.0,0,2.0,3,20,6.7,0,2.0,4,40,10.0,0,,tyler-scott-3
846,Branden Mack,Temple,American,7,4,19,4.8,0,2.7,26,291,11.2,3,41.6,30,310,10.3,3,,branden-mack-1
847,Braydon Johnson,Oklahoma State,Big 12,11,1,19,19.0,0,1.7,20,248,12.4,1,22.5,21,267,12.7,1,,braydon-johnson-1
848,Devon High,Navy,American,9,2,19,9.5,0,2.1,1,4,4.0,0,0.4,3,23,7.7,0,,devon-high-1
849,Gerry Bohanon,Baylor,Big 12,2,4,19,4.8,0,9.5,0,0,,0,0.0,4,19,4.8,0,,gerry-bohanon-1
850,Jordan Blackman,Army,Ind,3,2,19,9.5,1,6.3,0,0,,0,0.0,2,19,9.5,1,,jordan-blackman-1
851,Jordan Gidrey,Air Force,MWC,6,11,19,1.7,0,3.2,0,0,,0,0.0,11,19,1.7,0,,jordan-gidrey-1
852,Odunayo Seriki,South Florida,American,4,6,19,3.2,0,4.8,0,0,,0,0.0,6,19,3.2,0,,odunayo-seriki-1
853,Ontario Russell,Miami (OH),MAC,3,14,19,1.4,0,6.3,0,0,,0,0.0,14,19,1.4,0,,ontario-russell-1
854,Phat Watts,Tulane,American,12,5,19,3.8,1,1.6,17,217,12.8,0,18.1,22,236,10.7,1,,phat-watts-1
855,Terrance Gipson,SMU,American,4,7,19,2.7,1,4.8,0,0,,0,0.0,7,19,2.7,1,,terrance-gipson-1
856,Will Drawdy,Wake Forest,ACC,4,4,19,4.8,1,4.8,0,0,,0,0.0,4,19,4.8,1,,will-drawdy-1
857,Ahmani Marshall,Wake Forest,ACC,2,6,18,3.0,0,9.0,0,0,,0,0.0,6,18,3.0,0,,ahmani-marshall-1
858,Alante Brown,Nebraska,Big Ten,8,1,18,18.0,0,2.3,3,41,13.7,0,5.1,4,59,14.8,0,,alante-brown-1
859,Ben Peterson,Air Force,MWC,6,1,18,18.0,0,3.0,3,95,31.7,1,15.8,4,113,28.3,1,,ben-peterson-1
860,Bradrick Shaw,California,Pac-12,3,11,18,1.6,1,6.0,0,0,,0,0.0,11,18,1.6,1,,bradrick-shaw-1
861,Devin Chandler,Wisconsin,Big Ten,4,1,18,18.0,0,4.5,2,28,14.0,0,7.0,3,46,15.3,0,,devin-chandler-1
862,DJ Smith,Eastern Michigan,MAC,4,18,18,1.0,0,4.5,3,26,8.7,1,6.5,21,44,2.1,1,,dj-smith-2
863,Gabe Montgomery,Appalachian State,Sun Belt,8,2,18,9.0,0,2.3,0,0,,0,0.0,2,18,9.0,0,,gabe-montgomery-1
864,Jake Haener,Fresno State,MWC,6,57,18,0.3,3,3.0,0,0,,0,0.0,57,18,0.3,3,,jake-haener-1
865,Jeremy Hunt,Louisiana-Monroe,Sun Belt,7,35,18,0.5,1,2.6,0,0,,0,0.0,35,18,0.5,1,,jeremy-hunt-1
866,Jerney Jones,Missouri,SEC,10,4,18,4.5,0,1.8,0,0,,0,0.0,4,18,4.5,0,,jerney-jones-1
867,Khalil McClain,Troy,Sun Belt,11,2,18,9.0,0,1.6,32,383,12.0,6,34.8,34,401,11.8,6,,khalil-mcclain-1
868,Kody Epps,BYU,Ind,6,2,18,9.0,0,3.0,5,47,9.4,0,7.8,7,65,9.3,0,,kody-epps-1
869,Adam Korsak,Rutgers,Big Ten,9,1,17,17.0,0,1.9,0,0,,0,0.0,1,17,17.0,0,,adam-korsak-1
870,Ben Skowronek,Notre Dame,ACC,11,2,17,8.5,1,1.5,29,439,15.1,5,39.9,31,456,14.7,6,,ben-skowronek-1
871,D'Wan Mathis,Georgia,SEC,4,18,17,0.9,0,4.3,0,0,,0,0.0,18,17,0.9,0,,dwan-mathis-1
872,Evan Johnson,North Texas,CUSA,2,6,17,2.8,0,8.5,0,0,,0,0.0,6,17,2.8,0,,evan-johnson-1
873,Jacardia Wright,Kansas State,Big 12,4,6,17,2.8,0,4.3,0,0,,0,0.0,6,17,2.8,0,,jacardia-wright-1
874,Jacob Copeland,Florida,SEC,11,1,17,17.0,0,1.5,23,435,18.9,3,39.5,24,452,18.8,3,,jacob-copeland-1
875,Jarrett Guarantano,Tennessee,SEC,7,41,17,0.4,4,2.4,0,0,,0,0.0,41,17,0.4,4,,jarrett-guarantano-1
876,Jayden Reed,Michigan State,Big Ten,7,6,17,2.8,0,2.4,33,407,12.3,3,58.1,39,424,10.9,3,,jayden-reed-1
877,Jerry Howard,Georgia Tech,ACC,10,3,17,5.7,0,1.7,1,8,8.0,0,0.8,4,25,6.3,0,,jerry-howard-2
878,Jonah White,Baylor,Big 12,2,5,17,3.4,0,8.5,9,63,7.0,0,31.5,14,80,5.7,0,,jonah-white-1
879,Kurtis Rourke,Ohio,MAC,3,14,17,1.2,0,5.7,0,0,,0,0.0,14,17,1.2,0,,kurtis-rourke-1
880,Marvin Mims,Oklahoma,Big 12,11,2,17,8.5,0,1.5,37,610,16.5,9,55.5,39,627,16.1,9,,marvin-mims-1
881,Shocky Jacques-Louis,Pitt,ACC,10,5,17,3.4,0,1.7,26,327,12.6,0,32.7,31,344,11.1,0,,shocky-jacques-louis-1
882,Taron Keith,Bowling Green,MAC,1,4,17,4.3,0,17.0,0,0,,0,0.0,4,17,4.3,0,,taron-keith-1
883,Tylan Knight,Ole Miss,SEC,10,5,17,3.4,0,1.7,2,9,4.5,0,0.9,7,26,3.7,0,,tylan-knight-1
884,Xavier Johnson,Ohio State,Big Ten,6,4,17,4.3,0,2.8,0,0,,0,0.0,4,17,4.3,0,,xavier-johnson-2
885,Christian Parrish,Army,Ind,3,5,16,3.2,0,5.3,0,0,,0,0.0,5,16,3.2,0,,christian-parrish-1
886,CJ Harris,Ohio,MAC,1,3,16,5.3,0,16.0,0,0,,0,0.0,3,16,5.3,0,,cj-harris-2
887,Darius Lewis,Georgia Southern,Sun Belt,11,1,16,16.0,0,1.5,3,19,6.3,0,1.7,4,35,8.8,0,,darius-lewis-1
888,Earnest Crownover,Texas A&M,SEC,4,3,16,5.3,0,4.0,0,0,,0,0.0,3,16,5.3,0,,earnest-crownover-1
889,Jairus Grissom,Eastern Michigan,MAC,2,5,16,3.2,0,8.0,0,0,,0,0.0,5,16,3.2,0,,jairus-grissom-1
890,Jake Bailey,Rice,CUSA,5,2,16,8.0,0,3.2,23,276,12.0,2,55.2,25,292,11.7,2,,jake-bailey-2
891,Jayden Harrison,Vanderbilt,SEC,9,1,16,16.0,0,1.8,8,20,2.5,0,2.2,9,36,4.0,0,,jayden-harrison-1
892,Kaylon Geiger,Troy,Sun Belt,11,4,16,4.0,0,1.5,64,752,11.8,3,68.4,68,768,11.3,3,,kaylon-geiger-1
893,Marco Lee,Virginia Tech,ACC,1,3,16,5.3,0,16.0,0,0,,0,0.0,3,16,5.3,0,,marco-lee-1
894,Marquez Stevenson,Houston,American,5,3,16,5.3,0,3.2,20,307,15.4,4,61.4,23,323,14.0,4,,marquez-stevenson-1
895,Shamar Garrett,San Jose State,MWC,7,3,16,5.3,0,2.3,4,35,8.8,0,5.0,7,51,7.3,0,,shamar-garrett-1
896,T.J. Simmons,West Virginia,Big 12,8,2,16,8.0,0,2.0,23,401,17.4,4,50.1,25,417,16.7,4,,tj-simmons-4
897,Velus Jones Jr.,Tennessee,SEC,10,3,16,5.3,0,1.6,22,280,12.7,3,28.0,25,296,11.8,3,,velus-jones-jr-1
898,A.J. Henning,Michigan,Big Ten,6,3,15,5.0,0,2.5,6,59,9.8,0,9.8,9,74,8.2,0,,aj-henning-1
899,Ben Brittain,Air Force,MWC,2,4,15,3.8,0,7.5,0,0,,0,0.0,4,15,3.8,0,,ben-brittain-1
900,Brennan Presley,Oklahoma State,Big 12,11,2,15,7.5,1,1.4,7,125,17.9,3,11.4,9,140,15.6,4,,brennan-presley-1
901,Chase Wolf,Wisconsin,Big Ten,3,4,15,3.8,0,5.0,0,0,,0,0.0,4,15,3.8,0,,chase-wolf-1
902,Deondre Jackson,Texas A&M,SEC,1,2,15,7.5,0,15.0,0,0,,0,0.0,2,15,7.5,0,,deondre-jackson-1
903,Gayflor Flomo,Kansas,Big 12,9,6,15,2.5,0,1.7,0,0,,0,0.0,6,15,2.5,0,,gayflor-flomo-1
904,Gunner Romney,BYU,Ind,10,6,15,2.5,1,1.5,39,767,19.7,2,76.7,45,782,17.4,3,,gunner-romney-1
905,Jahmir Smith,Notre Dame,ACC,1,5,15,3.0,0,15.0,0,0,,0,0.0,5,15,3.0,0,,jahmir-smith-1
906,Javon McKinley,Notre Dame,ACC,12,1,15,15.0,0,1.3,42,717,17.1,3,59.8,43,732,17.0,3,,javon-mckinley-1
907,Josh Ali,Kentucky,SEC,11,1,15,15.0,0,1.4,54,473,8.8,1,43.0,55,488,8.9,1,,josh-ali-1
908,Layne Hatcher,Arkansas State,Sun Belt,11,43,15,0.3,0,1.4,0,0,,0,0.0,43,15,0.3,0,,layne-hatcher-1
909,Masen Wake,BYU,Ind,12,5,15,3.0,2,1.3,8,114,14.3,1,9.5,13,129,9.9,3,,masen-wake-1
910,Michael Lindauer,Cincinnati,American,2,2,15,7.5,0,7.5,0,0,,0,0.0,2,15,7.5,0,,michael-lindauer-1
911,Mike Wright,Vanderbilt,SEC,6,14,15,1.1,1,2.5,0,0,,0,0.0,14,15,1.1,1,,mike-wright-8
912,Seth Boomer,Tulsa,American,2,4,15,3.8,0,7.5,0,0,,0,0.0,4,15,3.8,0,,seth-boomer-1
913,Tyler Lytle,Colorado,Pac-12,2,1,15,15.0,0,7.5,0,0,,0,0.0,1,15,15.0,0,,tyler-lytle-1
914,Calvin Austin III,Memphis,American,11,2,14,7.0,0,1.3,63,1053,16.7,11,95.7,65,1067,16.4,11,,calvin-austin-iii-1
915,Chad Alexander,New Mexico,MWC,6,3,14,4.7,0,2.3,5,10,2.0,0,1.7,8,24,3.0,0,,chad-alexander-4
916,Conner Lillig,Illinois,Big Ten,3,3,14,4.7,0,4.7,0,0,,0,0.0,3,14,4.7,0,,conner-lillig-1
917,Jalen McMillan,Washington,Pac-12,3,2,14,7.0,0,4.7,1,16,16.0,0,5.3,3,30,10.0,0,,jalen-mcmillan-1
918,J.J. Pegues,Auburn,SEC,11,5,14,2.8,0,1.3,7,57,8.1,0,5.2,12,71,5.9,0,,jj-pegues-1
919,Mac Jones,Alabama,SEC,13,35,14,0.4,1,1.1,1,-8,-8.0,0,-0.6,36,6,0.2,1,H-3AA,mac-jones-1
920,Marcus Crowley,Ohio State,Big Ten,4,6,14,2.3,0,3.5,1,4,4.0,0,1.0,7,18,2.6,0,,marcus-crowley-1
921,Oscar Bradburn,Virginia Tech,ACC,10,1,14,14.0,0,1.4,0,0,,0,0.0,1,14,14.0,0,,oscar-bradburn-1
922,Tanner Wiggins,Louisiana,Sun Belt,10,1,14,14.0,0,1.4,0,0,,0,0.0,1,14,14.0,0,,tanner-wiggins-1
923,Trevon Bradford,Oregon State,Pac-12,5,2,14,7.0,0,2.8,24,239,10.0,1,47.8,26,253,9.7,1,,trevon-bradford-1
924,Willie Johnson,Marshall,CUSA,8,4,14,3.5,0,1.8,18,268,14.9,2,33.5,22,282,12.8,2,,willie-johnson-5
925,Ben Wooldridge,Fresno State,MWC,2,2,13,6.5,0,6.5,0,0,,0,0.0,2,13,6.5,0,,ben-wooldridge-1
926,Brandon Wright,Michigan State,Big Ten,6,6,13,2.2,0,2.2,1,13,13.0,0,2.2,7,26,3.7,0,,brandon-wright-4
927,Bryce Williams,Minnesota,Big Ten,3,5,13,2.6,0,4.3,2,13,6.5,0,4.3,7,26,3.7,0,,bryce-williams-4
928,Demarcus Jones,Southern Mississippi,CUSA,10,4,13,3.3,0,1.3,29,265,9.1,1,26.5,33,278,8.4,1,,demarcus-jones-4
929,Jacob Zeno,Baylor,Big 12,1,4,13,3.3,0,13.0,0,0,,0,0.0,4,13,3.3,0,,jacob-zeno-1
930,Jensen Jones,Air Force,MWC,1,2,13,6.5,0,13.0,0,0,,0,0.0,2,13,6.5,0,,jensen-jones-1
931,Josh Mays,Troy,Sun Belt,8,4,13,3.3,0,1.6,0,0,,0,0.0,4,13,3.3,0,,josh-mays-1
932,Kamal Gray,Temple,American,1,2,13,6.5,0,13.0,0,0,,0,0.0,2,13,6.5,0,,kamal-gray-1
933,Micah Davis,Air Force,MWC,4,1,13,13.0,0,3.3,0,0,,0,0.0,1,13,13.0,0,,micah-davis-1
934,Mike Harley,Miami (FL),ACC,11,2,13,6.5,0,1.2,57,799,14.0,7,72.6,59,812,13.8,7,,mike-harley-1
935,Nathan Tilford,Arizona,Pac-12,1,2,13,6.5,0,13.0,0,0,,0,0.0,2,13,6.5,0,,nathan-tilford-1
936,Noah Cain,Penn State,Big Ten,1,3,13,4.3,0,13.0,0,0,,0,0.0,3,13,4.3,0,,noah-cain-1
937,Prather Hudson,Georgia,SEC,10,3,13,4.3,0,1.3,0,0,,0,0.0,3,13,4.3,0,,prather-hudson-1
938,Seth Paige,Georgia State,Sun Belt,1,5,13,2.6,0,13.0,1,8,8.0,0,8.0,6,21,3.5,0,,seth-paige-1
939,Bobby Wooden,New Mexico,MWC,7,4,12,3.0,0,1.7,8,42,5.3,0,6.0,12,54,4.5,0,,bobby-wooden-1
940,Clay Markoff,Washington State,Pac-12,4,4,12,3.0,0,3.0,1,7,7.0,0,1.8,5,19,3.8,0,,clay-markoff-1
941,De'Corian Clark,UTSA,CUSA,11,1,12,12.0,0,1.1,8,58,7.3,1,5.3,9,70,7.8,1,,decorian-clark-1
942,Demario McCall,Ohio State,Big Ten,6,1,12,12.0,0,2.0,1,27,27.0,0,4.5,2,39,19.5,0,,demario-mccall-1
943,Elieyzay Anderson,New Mexico State,Ind,1,5,12,2.4,0,12.0,0,0,,0,0.0,5,12,2.4,0,,elieyzay-anderson-1
944,Hunter Dekkers,Iowa State,Big 12,3,3,12,4.0,1,4.0,0,0,,0,0.0,3,12,4.0,1,,hunter-dekkers-1
945,Jaylen Waddle,Alabama,SEC,6,3,12,4.0,0,2.0,28,591,21.1,4,98.5,31,603,19.5,4,,jaylen-waddle-1
946,Mark Pope,Miami (FL),ACC,11,1,12,12.0,0,1.1,33,403,12.2,2,36.6,34,415,12.2,2,,mark-pope-1
947,Perris Jones,Virginia,ACC,10,3,12,4.0,0,1.2,2,3,1.5,0,0.3,5,15,3.0,0,,perris-jones-1
948,Reggie Love III,Illinois,Big Ten,7,10,12,1.2,0,1.7,0,0,,0,0.0,10,12,1.2,0,,reggie-love-iii-1
949,Sam Kenerson,Georgia Southern,Sun Belt,4,2,12,6.0,0,3.0,0,0,,0,0.0,2,12,6.0,0,,sam-kenerson-1
950,Seth Keller,Texas State,Sun Belt,10,1,12,12.0,1,1.2,0,0,,0,0.0,1,12,12.0,1,,seth-keller-1
951,Terrell Brown,Houston,American,4,4,12,3.0,0,3.0,0,0,,0,0.0,4,12,3.0,0,,terrell-brown-3
952,Zahir Swann,Central Michigan,MAC,4,1,12,12.0,0,3.0,0,0,,0,0.0,1,12,12.0,0,,zahir-swann-1
953,A'Montae Spivey,Arkansas,SEC,5,4,11,2.8,0,2.2,0,0,,0,0.0,4,11,2.8,0,,amontae-spivey-1
954,Bryce Carpenter,Coastal Carolina,Sun Belt,8,4,11,2.8,0,1.4,2,18,9.0,0,2.3,6,29,4.8,0,,bryce-carpenter-1
955,Davis Brin,Tulsa,American,2,4,11,2.8,1,5.5,0,0,,0,0.0,4,11,2.8,1,,davis-brin-1
956,Hudson Card,Texas,Big 12,2,4,11,2.8,0,5.5,0,0,,0,0.0,4,11,2.8,0,,hudson-card-1
957,Jake Smith,Texas,Big 12,7,2,11,5.5,0,1.6,23,294,12.8,3,42.0,25,305,12.2,3,,jake-smith-7
958,Ja'khi Douglas,Florida State,ACC,8,6,11,1.8,0,1.4,7,116,16.6,2,14.5,13,127,9.8,2,,jakhi-douglas-1
959,Jalen Nailor,Michigan State,Big Ten,7,2,11,5.5,0,1.6,26,515,19.8,4,73.6,28,526,18.8,4,,jalen-nailor-1
960,Jonathan Barna,Ohio,MAC,1,8,11,1.4,0,11.0,0,0,,0,0.0,8,11,1.4,0,,jonathan-barna-1
961,Justin Rogers,Nevada-Las Vegas,MWC,3,10,11,1.1,0,3.7,0,0,,0,0.0,10,11,1.1,0,,justin-rogers-3
962,Karmi Mackey,Eastern Michigan,MAC,1,3,11,3.7,0,11.0,1,12,12.0,0,12.0,4,23,5.8,0,,karmi-mackey-1
963,Kentrel Bullock,Ole Miss,SEC,6,2,11,5.5,0,1.8,0,0,,0,0.0,2,11,5.5,0,,kentrel-bullock-1
964,Kyron Cumby,Illinois,Big Ten,5,2,11,5.5,0,2.2,3,16,5.3,0,3.2,5,27,5.4,0,,kyron-cumby-1
965,Nick Patti,Pitt,ACC,2,7,11,1.6,2,5.5,0,0,,0,0.0,7,11,1.6,2,,nick-patti-3
966,Nikko Remigio,California,Pac-12,4,3,11,3.7,0,2.8,10,90,9.0,2,22.5,13,101,7.8,2,,nikko-remigio-1
967,Stefan Cobbs,Boise State,MWC,7,2,11,5.5,0,1.6,4,72,18.0,0,10.3,6,83,13.8,0,,stefan-cobbs-1
968,Tahj Washington,Memphis,American,11,4,11,2.8,1,1.0,43,743,17.3,6,67.5,47,754,16.0,7,,tahj-washington-1
969,Aidan Robbins,Louisville,ACC,7,5,10,2.0,0,1.4,0,0,,0,0.0,5,10,2.0,0,,aidan-robbins-1
970,Andrew Parchment,Kansas,Big 12,8,1,10,10.0,0,1.3,24,197,8.2,2,24.6,25,207,8.3,2,,andrew-parchment-1
971,A'varius Sparrow,West Virginia,Big 12,6,3,10,3.3,0,1.7,0,0,,0,0.0,3,10,3.3,0,,avarius-sparrow-1
972,Cammon Cooper,Washington State,Pac-12,2,4,10,2.5,0,5.0,0,0,,0,0.0,4,10,2.5,0,,cammon-cooper-1
973,Jordan Myers,Rice,CUSA,5,9,10,1.1,1,2.0,24,209,8.7,1,41.8,33,219,6.6,2,,jordan-myers-1
974,Kenyon Oblad,Nevada-Las Vegas,MWC,1,2,10,5.0,0,10.0,0,0,,0,0.0,2,10,5.0,0,,kenyon-oblad-1
975,KeSean Carter,Texas Tech,Big 12,6,1,10,10.0,0,1.7,30,290,9.7,4,48.3,31,300,9.7,4,,kesean-carter-1
976,Luke Grimm,Kansas,Big 12,6,3,10,3.3,0,1.7,19,255,13.4,2,42.5,22,265,12.0,2,,luke-grimm-1
977,Patrick O'Brien,Colorado State,MWC,4,23,10,0.4,2,2.5,0,0,,0,0.0,23,10,0.4,2,,patrick-obrien-1
978,Brandon Hayes,Southern Mississippi,CUSA,7,1,9,9.0,0,1.3,8,59,7.4,0,8.4,9,68,7.6,0,,brandon-hayes-2
979,Bryan Thompson,Utah,Pac-12,5,1,9,9.0,1,1.8,9,187,20.8,1,37.4,10,196,19.6,2,,bryan-thompson-1
980,Chad Magyar,Nevada-Las Vegas,MWC,3,2,9,4.5,0,3.0,0,0,,0,0.0,2,9,4.5,0,,chad-magyar-1
981,D'ionte Smith,Missouri,SEC,8,1,9,9.0,0,1.1,8,65,8.1,0,8.1,9,74,8.2,0,,dionte-smith-1
982,Gunnar Holmberg,Duke,ACC,6,23,9,0.4,1,1.5,0,0,,0,0.0,23,9,0.4,1,,gunnar-holmberg-1
983,Isaiah Hamilton,San Jose State,MWC,8,1,9,9.0,0,1.1,13,206,15.8,2,25.8,14,215,15.4,2,,isaiah-hamilton-2
984,Jalen Virgil,Appalachian State,Sun Belt,9,1,9,9.0,0,1.0,22,225,10.2,3,25.0,23,234,10.2,3,,jalen-virgil-1
985,James Smith,Cincinnati,American,10,1,9,9.0,0,0.9,0,0,,0,0.0,1,9,9.0,0,,james-smith-8
986,Jesiah Irish,Oregon State,Pac-12,6,1,9,9.0,0,1.5,0,0,,0,0.0,1,9,9.0,0,,jesiah-irish-1
987,Jordan Kress,New Mexico,MWC,4,2,9,4.5,0,2.3,12,224,18.7,2,56.0,14,233,16.6,2,,jordan-kress-1
988,Jordan Kress,New Mexico,MWC,4,2,9,4.5,0,2.3,12,224,18.7,2,56.0,14,233,16.6,2,,jordan-kress-2
989,Josh Adkins,UTSA,CUSA,5,2,9,4.5,0,1.8,0,0,,0,0.0,2,9,4.5,0,,josh-adkins-1
990,Justin Lockhart,Nevada,MWC,9,1,9,9.0,0,1.0,27,241,8.9,2,26.8,28,250,8.9,2,,justin-lockhart-1
991,Kai Money,Texas,Big 12,10,1,9,9.0,0,0.9,10,76,7.6,1,7.6,11,85,7.7,1,,kai-money-1
992,Kendric Pryor,Wisconsin,Big Ten,3,2,9,4.5,0,3.0,8,119,14.9,0,39.7,10,128,12.8,0,,kendric-pryor-1
993,Myron Mitchell,UAB,CUSA,9,1,9,9.0,0,1.0,29,436,15.0,3,48.4,30,445,14.8,3,,myron-mitchell-1
994,Roman Wilson,Michigan,Big Ten,6,1,9,9.0,0,1.5,9,122,13.6,1,20.3,10,131,13.1,1,,roman-wilson-1
995,Takulve Williams,Kansas,Big 12,6,1,9,9.0,0,1.5,19,95,5.0,0,15.8,20,104,5.2,0,,takulve-williams-1
996,Wayne Toussant,Louisiana Tech,CUSA,10,1,9,9.0,0,0.9,14,186,13.3,2,18.6,15,195,13.0,2,,wayne-toussant-1
997,Amad Anderson Jr.,Purdue,Big Ten,5,1,8,8.0,0,1.6,5,19,3.8,0,3.8,6,27,4.5,0,,amad-anderson-jr-1
998,Ay'Juan Marshall,Army,Ind,9,6,8,1.3,0,0.9,0,0,,0,0.0,6,8,1.3,0,,ayjuan-marshall-1
999,Brad Anderson,Middle Tennessee State,CUSA,9,2,8,4.0,0,0.9,6,60,10.0,0,6.7,8,68,8.5,0,,brad-anderson-3
1000,Braden Lenzy,Notre Dame,ACC,7,3,8,2.7,0,1.1,7,63,9.0,1,9.0,10,71,7.1,1,,braden-lenzy-1
1001,Brandon Thomas,Memphis,American,4,2,8,4.0,0,2.0,0,0,,0,0.0,2,8,4.0,0,,brandon-thomas-5
1002,Champ Flemings,Oregon State,Pac-12,5,1,8,8.0,0,1.6,10,107,10.7,0,21.4,11,115,10.5,0,,champ-flemings-1
1003,Dylan Downing,Nevada-Las Vegas,MWC,2,3,8,2.7,0,4.0,2,8,4.0,0,4.0,5,16,3.2,0,,dylan-downing-2
1004,Jacob Huesman,Appalachian State,Sun Belt,6,1,8,8.0,1,1.3,0,0,,0,0.0,1,8,8.0,1,,jacob-huesman-1
1005,Jafar Armstrong,Notre Dame,ACC,4,17,8,0.5,1,2.0,3,38,12.7,0,9.5,20,46,2.3,1,,jafar-armstrong-1
1006,Jafar Armstrong,Notre Dame,ACC,12,17,8,0.5,1,0.7,3,38,12.7,0,3.2,20,46,2.3,1,,jafar-armstrong-2
1007,Jose Barbon,Temple,American,5,1,8,8.0,0,1.6,8,82,10.3,0,16.4,9,90,10.0,0,,jose-barbon-1
1008,Josh Kelly,Fresno State,MWC,6,2,8,4.0,1,1.3,22,330,15.0,1,55.0,24,338,14.1,2,,josh-kelly-2
1009,Justus Woods,Stanford,Pac-12,4,4,8,2.0,0,2.0,0,0,,0,0.0,4,8,2.0,0,,justus-woods-1
1010,Maasai Maynor,Navy,American,1,1,8,8.0,0,8.0,0,0,,0,0.0,1,8,8.0,0,,maasai-maynor-1
1011,Malik Washington,Northwestern,Big Ten,5,1,8,8.0,0,1.6,5,51,10.2,0,10.2,6,59,9.8,0,,malik-washington-1
1012,Mark Walker,Navy,American,10,5,8,1.6,0,0.8,13,175,13.5,0,17.5,18,183,10.2,0,,mark-walker-5
1013,Matlin Marshall,Georgia State,Sun Belt,10,3,8,2.7,0,0.8,3,39,13.0,0,3.9,6,47,7.8,0,,matlin-marshall-1
1014,Nate McCollum,Georgia Tech,ACC,6,2,8,4.0,0,1.3,2,15,7.5,0,2.5,4,23,5.8,0,,nate-mccollum-1
1015,Quadraiz Wadley,UTEP,CUSA,1,3,8,2.7,0,8.0,0,0,,0,0.0,3,8,2.7,0,,quadraiz-wadley-1
1016,Talmage Gunther,BYU,Ind,12,2,8,4.0,0,0.7,0,0,,0,0.0,2,8,4.0,0,,talmage-gunther-1
1017,Tanner McGee,South Alabama,Sun Belt,2,4,8,2.0,0,4.0,0,0,,0,0.0,4,8,2.0,0,,tanner-mcgee-1
1018,Whop Philyor,Indiana,Big Ten,8,1,8,8.0,0,1.0,54,495,9.2,3,61.9,55,503,9.1,3,,whop-philyor-1
1019,Zakhari Franklin,UTSA,CUSA,10,1,8,8.0,0,0.8,49,694,14.2,7,69.4,50,702,14.0,7,,zakhari-franklin-1
1020,Alex Padilla,Iowa,Big Ten,2,2,7,3.5,0,3.5,0,0,,0,0.0,2,7,3.5,0,,alex-padilla-1
1021,Ben Ballard,Texas,Big 12,1,1,7,7.0,0,7.0,0,0,,0,0.0,1,7,7.0,0,,ben-ballard-1
1022,Cade McNamara,Michigan,Big Ten,4,5,7,1.4,1,1.8,0,0,,0,0.0,5,7,1.4,1,,cade-mcnamara-1
1023,Chance Lovertich,South Alabama,Sun Belt,6,19,7,0.4,0,1.2,0,0,,0,0.0,19,7,0.4,0,,chance-lovertich-1
1024,Christian Singleton,Western Michigan,MAC,1,2,7,3.5,1,7.0,0,0,,0,0.0,2,7,3.5,1,,christian-singleton-1
1025,Dashaun Jerkins,Vanderbilt,SEC,8,1,7,7.0,0,0.9,0,0,,0,0.0,1,7,7.0,0,,dashaun-jerkins-1
1026,Devin Leary,North Carolina State,ACC,4,19,7,0.4,0,1.8,0,0,,0,0.0,19,7,0.4,0,,devin-leary-1
1027,Jackson He,Arizona State,Pac-12,2,4,7,1.8,1,3.5,0,0,,0,0.0,4,7,1.8,1,,jackson-he-2
1028,Jared Cole,Massachusetts,Ind,4,12,7,0.6,0,1.8,2,13,6.5,0,3.3,14,20,1.4,0,,jared-cole-1
1029,Josh Coltrin,Tulane,American,1,2,7,3.5,0,7.0,0,0,,0,0.0,2,7,3.5,0,,josh-coltrin-1
1030,Josh Fleeks,Baylor,Big 12,8,5,7,1.4,0,0.9,21,181,8.6,1,22.6,26,188,7.2,1,,josh-fleeks-1
1031,Kyle Toole,Troy,Sun Belt,1,2,7,3.5,0,7.0,0,0,,0,0.0,2,7,3.5,0,,kyle-toole-1
1032,Logan Ammons,Tulane,American,2,1,7,7.0,0,3.5,0,0,,0,0.0,1,7,7.0,0,,logan-ammons-1
1033,Michael Kern,Wake Forest,ACC,5,8,7,0.9,0,1.4,0,0,,0,0.0,8,7,0.9,0,,michael-kern-1
1034,Milan Tucker,Appalachian State,Sun Belt,11,1,7,7.0,0,0.6,2,11,5.5,0,1.0,3,18,6.0,0,,milan-tucker-1
1035,Nate Jefferson,Florida International,CUSA,5,1,7,7.0,1,1.4,6,68,11.3,1,13.6,7,75,10.7,2,,nate-jefferson-1
1036,Roderic Burns,North Texas,CUSA,9,1,7,7.0,0,0.8,12,161,13.4,0,17.9,13,168,12.9,0,,roderic-burns-1
1037,Seth Green,Minnesota,Big Ten,7,9,7,0.8,2,1.0,3,38,12.7,0,5.4,12,45,3.8,2,,seth-green-1
1038,Tank Smith,Penn State,Big Ten,1,1,7,7.0,0,7.0,0,0,,0,0.0,1,7,7.0,0,,tank-smith-1
1039,Tylan Wallace,Oklahoma State,Big 12,10,1,7,7.0,0,0.7,59,922,15.6,6,92.2,60,929,15.5,6,,tylan-wallace-1
1040,Wesley Kommer,Nevada,MWC,6,1,7,7.0,0,1.2,0,0,,0,0.0,1,7,7.0,0,,wesley-kommer-1
1041,Willie Taggart Jr.,Florida Atlantic,CUSA,7,6,7,1.2,0,1.0,2,14,7.0,0,2.0,8,21,2.6,0,,willie-taggart-jr-1
1042,Ben Williams,Appalachian State,Sun Belt,1,2,6,3.0,0,6.0,0,0,,0,0.0,2,6,3.0,0,,ben-williams-4
1043,BJ Busbee,San Diego State,MWC,8,1,6,6.0,0,0.8,7,49,7.0,0,6.1,8,55,6.9,0,,bj-busbee-1
1044,Cameron Fleming,Memphis,American,1,1,6,6.0,0,6.0,0,0,,0,0.0,1,6,6.0,0,,cameron-fleming-2
1045,Dante Cephas,Kent State,MAC,4,1,6,6.0,0,1.5,11,136,12.4,0,34.0,12,142,11.8,0,,dante-cephas-1
1046,DeVonta Smith,Alabama,SEC,13,4,6,1.5,1,0.5,117,1856,15.9,23,142.8,121,1862,15.4,24,H-1MaxwellAACamp,devonta-smith-1
1047,Drew Lisk,Utah,Pac-12,1,1,6,6.0,0,6.0,0,0,,0,0.0,1,6,6.0,0,,drew-lisk-1
1048,Isaiah Sanders,Stanford,Pac-12,2,3,6,2.0,2,3.0,0,0,,0,0.0,3,6,2.0,2,,isaiah-sanders-1
1049,Isaiah Wooden,Kent State,MAC,3,1,6,6.0,0,2.0,4,94,23.5,1,31.3,5,100,20.0,1,,isaiah-wooden-1
1050,Jarrett Guest,Coastal Carolina,Sun Belt,1,1,6,6.0,0,6.0,0,0,,0,0.0,1,6,6.0,0,,jarrett-guest-1
1051,Jawaun Johnson,Louisiana Tech,CUSA,7,1,6,6.0,0,0.9,14,162,11.6,2,23.1,15,168,11.2,2,,jawaun-johnson-1
1052,Jimmy Holiday,Tennessee,SEC,8,1,6,6.0,0,0.8,0,0,,0,0.0,1,6,6.0,0,,jimmy-holiday-1
1053,Kyle Williams,Nevada-Las Vegas,MWC,6,2,6,3.0,0,1.0,35,426,12.2,2,71.0,37,432,11.7,2,,kyle-williams-11
1054,Leka Lotulelei,San Diego State,MWC,6,1,6,6.0,0,1.0,0,0,,0,0.0,1,6,6.0,0,,leka-lotulelei-1
1055,Marcus Cisco,Northwestern,Big Ten,1,3,6,2.0,0,6.0,0,0,,0,0.0,3,6,2.0,0,,marcus-cisco-1
1056,Mike Diliello,Middle Tennessee State,CUSA,1,2,6,3.0,0,6.0,0,0,,0,0.0,2,6,3.0,0,,mike-diliello-1
1057,Randle Jones,Temple,American,5,2,6,3.0,0,1.2,31,370,11.9,2,74.0,33,376,11.4,2,,randle-jones-1
1058,Shi Smith,South Carolina,SEC,9,6,6,1.0,0,0.7,57,633,11.1,4,70.3,63,639,10.1,4,,shi-smith-1
1059,Stanley Berryhill III,Arizona,Pac-12,5,1,6,6.0,0,1.2,23,227,9.9,3,45.4,24,233,9.7,3,,stanley-berryhill-iii-1
1060,Tanner Kuljian,San Diego State,MWC,8,1,6,6.0,0,0.8,0,0,,0,0.0,1,6,6.0,0,,tanner-kuljian-1
1061,Will Spiers,Clemson,ACC,12,1,6,6.0,0,0.5,0,0,,0,0.0,1,6,6.0,0,,will-spiers-1
1062,Anthony Williams Jr.,Michigan State,Big Ten,2,4,5,1.3,0,2.5,1,5,5.0,0,2.5,5,10,2.0,0,,anthony-williams-jr-1
1063,Brady Schipper,Wisconsin,Big Ten,3,4,5,1.3,0,1.7,1,6,6.0,0,2.0,5,11,2.2,0,,brady-schipper-1
1064,Daniel Jones,Navy,American,1,1,5,5.0,0,5.0,0,0,,0,0.0,1,5,5.0,0,,daniel-jones-5
1065,Darion Anderson,Georgia Southern,Sun Belt,12,1,5,5.0,0,0.4,8,92,11.5,0,7.7,9,97,10.8,0,,darion-anderson-1
1066,Devin Jennings,Wyoming,MWC,6,2,5,2.5,0,0.8,1,7,7.0,0,1.2,3,12,4.0,0,,devin-jennings-1
1067,D.J. Taylor,Arizona State,Pac-12,3,2,5,2.5,0,1.7,1,2,2.0,0,0.7,3,7,2.3,0,,dj-taylor-3
1068,Emeka Emezie,North Carolina State,ACC,12,1,5,5.0,0,0.4,47,738,15.7,5,61.5,48,743,15.5,5,,emeka-emezie-1
1069,Giles Jackson,Michigan,Big Ten,5,2,5,2.5,0,1.0,15,167,11.1,0,33.4,17,172,10.1,0,,giles-jackson-1
1070,Jack Dunn,Wisconsin,Big Ten,6,4,5,1.3,0,0.8,28,255,9.1,1,42.5,32,260,8.1,1,,jack-dunn-1
1071,Jack Dunn,Wisconsin,Big Ten,6,4,5,1.3,0,0.8,28,255,9.1,1,42.5,32,260,8.1,1,,jack-dunn-2
1072,Jacob Sirmon,Washington,Pac-12,1,2,5,2.5,0,5.0,0,0,,0,0.0,2,5,2.5,0,,jacob-sirmon-1
1073,Jarrett Smith,Texas,Big 12,2,2,5,2.5,0,2.5,0,0,,0,0.0,2,5,2.5,0,,jarrett-smith-1
1074,Jaylon Armstead,San Diego State,MWC,1,1,5,5.0,0,5.0,0,0,,0,0.0,1,5,5.0,0,,jaylon-armstead-1
1075,Jelani Woods,Oklahoma State,Big 12,10,1,5,5.0,0,0.5,8,129,16.1,1,12.9,9,134,14.9,1,,jelani-woods-1
1076,K.D. Nixon,Colorado,Pac-12,4,1,5,5.0,0,1.3,15,132,8.8,0,33.0,16,137,8.6,0,,kd-nixon-1
1077,Ma'jon Wright,Arizona,Pac-12,5,1,5,5.0,0,1.0,15,176,11.7,1,35.2,16,181,11.3,1,,majon-wright-1
1078,Malik Jackson,Louisiana-Monroe,Sun Belt,10,1,5,5.0,0,0.5,23,189,8.2,4,18.9,24,194,8.1,4,,malik-jackson-6
1079,Matt Duncan,Temple,American,1,4,5,1.3,0,5.0,0,0,,0,0.0,4,5,1.3,0,,matt-duncan-1
1080,Matt Robinson,Illinois,Big Ten,2,4,5,1.3,0,2.5,0,0,,0,0.0,4,5,1.3,0,,matt-robinson-6
1081,Melquan Stovall,Nevada,MWC,9,2,5,2.5,0,0.6,33,250,7.6,0,27.8,35,255,7.3,0,,melquan-stovall-1
1082,Mitchell Tinsley,Western Kentucky,CUSA,12,1,5,5.0,0,0.4,43,377,8.8,4,31.4,44,382,8.7,4,,mitchell-tinsley-1
1083,Parker Christensen,Wyoming,MWC,6,1,5,5.0,0,0.8,2,28,14.0,0,4.7,3,33,11.0,0,,parker-christensen-1
1084,Peyton Matocha,Miami (FL),ACC,1,2,5,2.5,0,5.0,0,0,,0,0.0,2,5,2.5,0,,peyton-matocha-1
1085,Rakim Jarrett,Maryland,Big Ten,4,1,5,5.0,0,1.3,17,252,14.8,2,63.0,18,257,14.3,2,,rakim-jarrett-1
1086,Rhett Rodriguez,Arizona,Pac-12,1,1,5,5.0,0,5.0,0,0,,0,0.0,1,5,5.0,0,,rhett-rodriguez-1
1087,Taylor Morin,Wake Forest,ACC,9,2,5,2.5,0,0.6,32,405,12.7,3,45.0,34,410,12.1,3,,taylor-morin-1
1088,Tez Johnson,Troy,Sun Belt,11,1,5,5.0,0,0.5,18,211,11.7,0,19.2,19,216,11.4,0,,tez-johnson-1
1089,Bruce Jordan-Swilling,Georgia Tech,ACC,8,4,4,1.0,0,0.5,0,0,,0,0.0,4,4,1.0,0,,bruce-jordan-swilling-1
1090,Bryce Miller,South Florida,American,9,1,4,4.0,0,0.4,33,327,9.9,3,36.3,34,331,9.7,3,,bryce-miller-1
1091,Challen Faamatau,Maryland,Big Ten,3,1,4,4.0,0,1.3,1,8,8.0,0,2.7,2,12,6.0,0,,challen-faamatau-1
1092,Chase Wester,BYU,Ind,1,1,4,4.0,0,4.0,0,0,,0,0.0,1,4,4.0,0,,chase-wester-1
1093,Connor Genal,New Mexico,MWC,2,1,4,4.0,0,2.0,0,0,,0,0.0,1,4,4.0,0,,connor-genal-1
1094,CT Thomas,Boise State,MWC,7,4,4,1.0,0,0.6,20,347,17.4,2,49.6,24,351,14.6,2,,ct-thomas-1
1095,Deven Thompkins,Utah State,MWC,4,2,4,2.0,0,1.0,20,214,10.7,1,53.5,22,218,9.9,1,,deven-thompkins-1
1096,Drew Pyne,Notre Dame,ACC,4,1,4,4.0,0,1.0,0,0,,0,0.0,1,4,4.0,0,,drew-pyne-1
1097,Dylan McDuffie,Buffalo,MAC,3,1,4,4.0,0,1.3,0,0,,0,0.0,1,4,4.0,0,,dylan-mcduffie-1
1098,Elijah Jones,Kansas,Big 12,9,1,4,4.0,0,0.4,0,0,,0,0.0,1,4,4.0,0,,elijah-jones-5
1099,Evan Prater,Cincinnati,American,1,2,4,2.0,0,4.0,0,0,,0,0.0,2,4,2.0,0,,evan-prater-1
1100,Garrett Dzuro,Massachusetts,Ind,3,12,4,0.3,0,1.3,0,0,,0,0.0,12,4,0.3,0,,garrett-dzuro-1
1101,Jackson Sirmon,Washington,Pac-12,4,1,4,4.0,0,1.0,0,0,,0,0.0,1,4,4.0,0,,jackson-sirmon-1
1102,JT Shrout,Tennessee,SEC,4,8,4,0.5,0,1.0,0,0,,0,0.0,8,4,0.5,0,,jt-shrout-1
1103,Justin Lescouflair,Army,Ind,3,1,4,4.0,0,1.3,0,0,,0,0.0,1,4,4.0,0,,justin-lescouflair-1
1104,Koali Nishigaya,Hawaii,MWC,3,1,4,4.0,1,1.3,2,36,18.0,0,12.0,3,40,13.3,1,,koali-nishigaya-1
1105,Larenzo McMillan,New Mexico State,Ind,1,2,4,2.0,0,4.0,0,0,,0,0.0,2,4,2.0,0,,larenzo-mcmillan-1
1106,Michael Bollinger,Liberty,Ind,9,1,4,4.0,0,0.4,1,13,13.0,1,1.4,2,17,8.5,1,,michael-bollinger-1
1107,MyJaden Horton,Akron,MAC,3,3,4,1.3,0,1.3,0,0,,0,0.0,3,4,1.3,0,,myjaden-horton-1
1108,N'Kosi Perry,Miami (FL),ACC,5,12,4,0.3,0,0.8,0,0,,0,0.0,12,4,0.3,0,,nkosi-perry-1
1109,Quincy Jountti,USC,Pac-12,6,2,4,2.0,0,0.7,0,0,,0,0.0,2,4,2.0,0,,quincy-jountti-1
1110,Raiqwon O'Neal,Rutgers,Big Ten,8,1,4,4.0,1,0.5,0,-13,,0,-1.6,1,-9,-9.0,1,,raiqwon-oneal-1
1111,Rob Fiorentino,Kansas,Big 12,7,2,4,2.0,0,0.6,0,0,,0,0.0,2,4,2.0,0,,rob-fiorentino-1
1112,Sam James,West Virginia,Big 12,9,1,4,4.0,0,0.4,31,300,9.7,2,33.3,32,304,9.5,2,,sam-james-1
1113,Taj Harris,Syracuse,ACC,10,1,4,4.0,0,0.4,58,733,12.6,5,73.3,59,737,12.5,5,,taj-harris-1
1114,T.J. Graham,Texas State,Sun Belt,12,1,4,4.0,0,0.3,24,271,11.3,2,22.6,25,275,11.0,2,,tj-graham-2
1115,Tommy Tremble,Notre Dame,ACC,12,1,4,4.0,0,0.3,19,213,11.2,0,17.8,20,217,10.9,0,,tommy-tremble-1
1116,Trevon Grimes,Florida,SEC,11,1,4,4.0,0,0.4,38,589,15.5,9,53.5,39,593,15.2,9,,trevon-grimes-1
1117,Winston Wright,West Virginia,Big 12,10,2,4,2.0,0,0.4,47,553,11.8,2,55.3,49,557,11.4,2,,winston-wright-1
1118,Alan Bowman,Texas Tech,Big 12,8,10,3,0.3,0,0.4,0,0,,0,0.0,10,3,0.3,0,,alan-bowman-1
1119,Andrew Haidet,Northern Illinois,MAC,4,3,3,1.0,1,0.8,0,0,,0,0.0,3,3,1.0,1,,andrew-haidet-1
1120,Antavious Willis,Southern Mississippi,CUSA,9,1,3,3.0,0,0.3,5,57,11.4,0,6.3,6,60,10.0,0,,antavious-willis-1
1121,Brandon Hill,Pitt,ACC,10,1,3,3.0,0,0.3,0,0,,0,0.0,1,3,3.0,0,,brandon-hill-4
1122,Britain Covey,Utah,Pac-12,4,5,3,0.6,0,0.8,19,264,13.9,3,66.0,24,267,11.1,3,,britain-covey-1
1123,Damon Hazelton Jr.,Missouri,SEC,9,2,3,1.5,0,0.3,30,397,13.2,1,44.1,32,400,12.5,1,,damon-hazelton-jr-1
1124,Desmond Trotter,South Alabama,Sun Belt,10,84,3,0.0,2,0.3,0,0,,0,0.0,84,3,0.0,2,,desmond-trotter-1
1125,Elijah Hamilton,Vanderbilt,SEC,8,1,3,3.0,0,0.4,0,0,,0,0.0,1,3,3.0,0,,elijah-hamilton-1
1126,Gunner Cruz,Washington State,Pac-12,1,2,3,1.5,0,3.0,0,0,,0,0.0,2,3,1.5,0,,gunner-cruz-1
1127,Jack Blumer,Kansas State,Big 12,10,1,3,3.0,0,0.3,0,0,,0,0.0,1,3,3.0,0,,jack-blumer-1
1128,Jadan Blue,Temple,American,6,1,3,3.0,0,0.5,41,371,9.0,5,61.8,42,374,8.9,5,,jadan-blue-1
1129,Jah'Marae Sheread,Texas State,Sun Belt,11,1,3,3.0,0,0.3,29,334,11.5,2,30.4,30,337,11.2,2,,jahmarae-sheread-1
1130,Jalen McGaughy,Ball State,MAC,7,2,3,1.5,0,0.4,5,171,34.2,3,24.4,7,174,24.9,3,,jalen-mcgaughy-1
1131,Jalin Hyatt,Tennessee,SEC,10,1,3,3.0,0,0.3,20,276,13.8,2,27.6,21,279,13.3,2,,jalin-hyatt-1
1132,Jayson VanHook,UTEP,CUSA,6,1,3,3.0,0,0.5,0,0,,0,0.0,1,3,3.0,0,,jayson-vanhook-1
1133,Josh Johnson,Tulsa,American,9,1,3,3.0,0,0.3,38,499,13.1,6,55.4,39,502,12.9,6,,josh-johnson-9
1134,Joshua Youngblood,Kansas State,Big 12,2,1,3,3.0,0,1.5,0,0,,0,0.0,1,3,3.0,0,,joshua-youngblood-1
1135,Kazmeir Allen,UCLA,Pac-12,2,2,3,1.5,0,1.5,3,40,13.3,0,20.0,5,43,8.6,0,,kazmeir-allen-1
1136,Kris Abrams-Draine,Missouri,SEC,5,1,3,3.0,0,0.6,2,4,2.0,0,0.8,3,7,2.3,0,,kris-abrams-draine-1
1137,Malik Sherrod,Fresno State,MWC,2,1,3,3.0,0,1.5,0,0,,0,0.0,1,3,3.0,0,,malik-sherrod-1
1138,Matt Myers,Buffalo,MAC,3,3,3,1.0,1,1.0,0,0,,0,0.0,3,3,1.0,1,,matt-myers-2
1139,Michael Mathison,Akron,MAC,4,1,3,3.0,0,0.8,11,111,10.1,2,27.8,12,114,9.5,2,,michael-mathison-1
1140,Milton Wright,Purdue,Big Ten,6,2,3,1.5,0,0.5,24,305,12.7,2,50.8,26,308,11.8,2,,milton-wright-1
1141,Noah Gray,Duke,ACC,10,2,3,1.5,0,0.3,29,285,9.8,2,28.5,31,288,9.3,2,,noah-gray-1
1142,Parker McNeil,Troy,Sun Belt,1,1,3,3.0,0,3.0,0,0,,0,0.0,1,3,3.0,0,,parker-mcneil-1
1143,Quentin Johnston,TCU,Big 12,9,3,3,1.0,2,0.3,22,487,22.1,2,54.1,25,490,19.6,4,,quentin-johnston-1
1144,R.J. Harvey,UCF,American,3,3,3,1.0,0,1.0,0,0,,0,0.0,3,3,1.0,0,,rj-harvey-1
1145,Stephan Bracey,Wisconsin,Big Ten,3,1,3,3.0,0,1.0,1,11,11.0,0,3.7,2,14,7.0,0,,stephan-bracey-1
1146,Artur Sitkowski,Rutgers,Big Ten,4,14,2,0.1,0,0.5,0,0,,0,0.0,14,2,0.1,0,,artur-sitkowski-1
1147,Boone Abbott,Hawaii,MWC,1,1,2,2.0,0,2.0,0,0,,0,0.0,1,2,2.0,0,,boone-abbott-1
1148,Cameron Odom,Ohio,MAC,3,1,2,2.0,0,0.7,2,35,17.5,0,11.7,3,37,12.3,0,,cameron-odom-1
1149,Chris Street,California,Pac-12,2,1,2,2.0,0,1.0,0,0,,0,0.0,1,2,2.0,0,,chris-street-1
1150,Cooper Jewett,Nebraska,Big Ten,2,1,2,2.0,0,1.0,1,-1,-1.0,0,-0.5,2,1,0.5,0,,cooper-jewett-1
1151,Daedae Hill,Central Michigan,MAC,6,1,2,2.0,0,0.3,0,0,,0,0.0,1,2,2.0,0,,daedae-hill-1
1152,Darvon Hubbard,Texas A&M,SEC,1,1,2,2.0,0,2.0,0,0,,0,0.0,1,2,2.0,0,,darvon-hubbard-1
1153,Dawson Downing,Missouri,SEC,10,1,2,2.0,0,0.2,1,7,7.0,0,0.7,2,9,4.5,0,,dawson-downing-1
1154,Demario Douglas,Liberty,Ind,11,1,2,2.0,0,0.2,32,363,11.3,3,33.0,33,365,11.1,3,,demario-douglas-1
1155,Deonte Sheffield,Florida State,ACC,9,1,2,2.0,0,0.2,0,0,,0,0.0,1,2,2.0,0,,deonte-sheffield-1
1156,Duece Watts,Tulane,American,12,1,2,2.0,0,0.2,31,512,16.5,6,42.7,32,514,16.1,6,,duece-watts-1
1157,Grant Loy,Auburn,SEC,3,2,2,1.0,0,0.7,0,0,,0,0.0,2,2,1.0,0,,grant-loy-1
1158,Isaac Vance,Kent State,MAC,4,1,2,2.0,0,0.5,17,148,8.7,0,37.0,18,150,8.3,0,,isaac-vance-1
1159,Jeremiah Josephs,Miami (OH),MAC,3,1,2,2.0,0,0.7,0,0,,0,0.0,1,2,2.0,0,,jeremiah-josephs-1
1160,Johnnie Lang,Iowa State,Big 12,6,3,2,0.7,0,0.3,4,24,6.0,0,4.0,7,26,3.7,0,,johnnie-lang-1
1161,Jonah Panoke,Hawaii,MWC,9,1,2,2.0,0,0.2,11,95,8.6,0,10.6,12,97,8.1,0,,jonah-panoke-1
1162,Julian Ross,Ohio,MAC,1,2,2,1.0,0,2.0,0,0,,0,0.0,2,2,1.0,0,,julian-ross-1
1163,Keenan Garber,Kansas State,Big 12,6,2,2,1.0,0,0.3,2,10,5.0,0,1.7,4,12,3.0,0,,keenan-garber-1
1164,Michael Woods,Arkansas,SEC,10,1,2,2.0,0,0.2,32,619,19.3,5,61.9,33,621,18.8,5,,michael-woods-4
1165,Nick Fedanzo,Illinois,Big Ten,7,1,2,2.0,0,0.3,0,0,,0,0.0,1,2,2.0,0,,nick-fedanzo-1
1166,Quadre Nicholson,Miami (OH),MAC,2,2,2,1.0,0,1.0,0,0,,0,0.0,2,2,1.0,0,,quadre-nicholson-1
1167,Riley Lees,Northwestern,Big Ten,9,6,2,0.3,0,0.2,20,214,10.7,2,23.8,26,216,8.3,2,,riley-lees-1
1168,Sean Ryan,West Virginia,Big 12,9,1,2,2.0,0,0.2,25,264,10.6,0,29.3,26,266,10.2,0,,sean-ryan-2
1169,Sylvester Mayers,Clemson,ACC,3,1,2,2.0,0,0.7,0,0,,0,0.0,1,2,2.0,0,,sylvester-mayers-1
1170,Ta'Ron Madison,Oregon State,Pac-12,1,1,2,2.0,0,2.0,0,0,,0,0.0,1,2,2.0,0,,taron-madison-1
1171,Terence Fall,BYU,Ind,3,1,2,2.0,0,0.7,0,0,,0,0.0,1,2,2.0,0,,terence-fall-1
1172,Trent Pennix,North Carolina State,ACC,11,1,2,2.0,0,0.2,3,11,3.7,1,1.0,4,13,3.3,1,,trent-pennix-1
1173,Walter Dawn,UTEP,CUSA,8,2,2,1.0,0,0.3,20,202,10.1,0,25.3,22,204,9.3,0,,walter-dawn-1
1174,AJ Mayer,Miami (OH),MAC,3,7,1,0.1,0,0.3,0,0,,0,0.0,7,1,0.1,0,,aj-mayer-1
1175,Andrew Mason,Rice,CUSA,5,1,1,1.0,0,0.2,6,74,12.3,0,14.8,7,75,10.7,0,,andrew-mason-1
1176,Andy Peters,Boise State,MWC,1,1,1,1.0,0,1.0,0,0,,0,0.0,1,1,1.0,0,,andy-peters-2
1177,Antwan Davis,Ball State,MAC,8,1,1,1.0,0,0.1,39,456,11.7,1,57.0,40,457,11.4,1,,antwan-davis-2
1178,Ayden Eberhardt,Wyoming,MWC,6,1,1,1.0,0,0.2,16,252,15.8,0,42.0,17,253,14.9,0,,ayden-eberhardt-1
1179,Brevin Jordan,Miami (FL),ACC,8,2,1,0.5,0,0.1,38,576,15.2,7,72.0,40,577,14.4,7,,brevin-jordan-1
1180,Cameron Ekanayake,Notre Dame,ACC,1,3,1,0.3,0,1.0,0,0,,0,0.0,3,1,0.3,0,,cameron-ekanayake-1
1181,Carson Baker,San Diego State,MWC,6,25,1,0.0,1,0.2,0,0,,0,0.0,25,1,0.0,1,,carson-baker-2
1182,Cole Schneider,UCF,American,10,1,1,1.0,1,0.1,0,0,,0,0.0,1,1,1.0,1,,cole-schneider-1
1183,Daniel Karlin,Duke,ACC,1,1,1,1.0,1,1.0,0,0,,0,0.0,1,1,1.0,1,,daniel-karlin-1
1184,Deuce Spann,Illinois,Big Ten,1,1,1,1.0,0,1.0,0,0,,0,0.0,1,1,1.0,0,,deuce-spann-1
1185,Ethan Fernea,UCLA,Pac-12,6,2,1,0.5,0,0.2,2,46,23.0,1,7.7,4,47,11.8,1,,ethan-fernea-1
1186,Jack West,Stanford,Pac-12,1,1,1,1.0,0,1.0,0,0,,0,0.0,1,1,1.0,0,,jack-west-4
1187,Jakari Norwood,Illinois,Big Ten,1,2,1,0.5,0,1.0,0,0,,0,0.0,2,1,0.5,0,,jakari-norwood-1
1188,James Mitchell,Virginia Tech,ACC,10,1,1,1.0,1,0.1,26,435,16.7,4,43.5,27,436,16.1,5,,james-mitchell-2
1189,Ja'Shaun Poke,Kent State,MAC,4,3,1,0.3,0,0.3,21,326,15.5,3,81.5,24,327,13.6,3,,jashaun-poke-1
1190,Jose Borregales,Miami (FL),ACC,11,1,1,1.0,0,0.1,0,0,,0,0.0,1,1,1.0,0,AA,jose-borregales-1
1191,Julius Davis,Wisconsin,Big Ten,1,1,1,1.0,0,1.0,0,0,,0,0.0,1,1,1.0,0,,julius-davis-1
1192,Kenney Solomon,Tennessee,SEC,10,1,1,1.0,0,0.1,0,0,,0,0.0,1,1,1.0,0,,kenney-solomon-1
1193,Kolby Taylor,Oregon State,Pac-12,6,1,1,1.0,0,0.2,20,224,11.2,1,37.3,21,225,10.7,1,,kolby-taylor-1
1194,Miller Forristall,Alabama,SEC,11,1,1,1.0,0,0.1,23,253,11.0,1,23.0,24,254,10.6,1,,miller-forristall-1
1195,Naricuss Driver,Southern Mississippi,CUSA,4,1,1,1.0,1,0.3,2,62,31.0,1,15.5,3,63,21.0,2,,naricuss-driver-1
1196,Nico Ragaini,Iowa,Big Ten,8,1,1,1.0,1,0.1,18,191,10.6,0,23.9,19,192,10.1,1,,nico-ragaini-1
1197,Nyles Pinckney,Clemson,ACC,12,1,1,1.0,1,0.1,0,0,,0,0.0,1,1,1.0,1,,nyles-pinckney-1
1198,Owen Burk,Air Force,MWC,1,2,1,0.5,0,1.0,0,0,,0,0.0,2,1,0.5,0,,owen-burk-1
1199,Porter Rooks,North Carolina State,ACC,12,2,1,0.5,0,0.1,24,276,11.5,0,23.0,26,277,10.7,0,,porter-rooks-1
1200,Saevion Johnson,Fresno State,MWC,4,1,1,1.0,0,0.3,0,0,,0,0.0,1,1,1.0,0,,saevion-johnson-1
1201,Savon Scarver,Utah State,MWC,4,1,1,1.0,0,0.3,5,48,9.6,1,12.0,6,49,8.2,1,,savon-scarver-1
1202,Seth Porter,Kansas State,Big 12,9,1,1,1.0,0,0.1,0,0,,0,0.0,1,1,1.0,0,,seth-porter-1
1203,Slade Bolden,Alabama,SEC,13,1,1,1.0,0,0.1,24,270,11.3,1,20.8,25,271,10.8,1,,slade-bolden-1
1204,Thomas Pannunzio,Colorado State,MWC,4,1,1,1.0,0,0.3,0,0,,0,0.0,1,1,1.0,0,,thomas-pannunzio-1
1205,Tyler Hunt,Michigan State,Big Ten,5,1,1,1.0,1,0.2,8,78,9.8,0,15.6,9,79,8.8,1,,tyler-hunt-6
1206,Wyatt Rector,Florida State,ACC,9,1,1,1.0,1,0.1,0,0,,0,0.0,1,1,1.0,1,,wyatt-rector-1
1207,Briggs Bourgeois,Southern Mississippi,CUSA,10,1,0,0.0,0,0.0,0,0,,0,0.0,1,0,0.0,0,,briggs-bourgeois-1
1208,Charles Norman,Louisiana-Monroe,Sun Belt,10,1,0,0.0,0,0.0,1,4,4.0,1,0.4,2,4,2.0,1,,charles-norman-1
1209,Chase Cunningham,Middle Tennessee State,CUSA,3,2,0,0.0,0,0.0,0,0,,0,0.0,2,0,0.0,0,,chase-cunningham-1
1210,Chris Olave,Ohio State,Big Ten,7,1,0,0.0,0,0.0,50,729,14.6,7,104.1,51,729,14.3,7,,chris-olave-1
1211,C.J. Wright,Georgia Southern,Sun Belt,10,1,0,0.0,0,0.0,0,0,,0,0.0,1,0,0.0,0,,cj-wright-1
1212,Jeremiah Hall,Oklahoma,Big 12,11,1,0,0.0,0,0.0,18,218,12.1,5,19.8,19,218,11.5,5,,jeremiah-hall-1
1213,Jermaine Johnson Jr.,Massachusetts,Ind,4,1,0,0.0,0,0.0,14,96,6.9,0,24.0,15,96,6.4,0,,jermaine-johnson-jr-1
1214,Johnny Wilson,Arizona State,Pac-12,3,1,0,0.0,0,0.0,6,89,14.8,0,29.7,7,89,12.7,0,,johnny-wilson-3
1215,Justin Smith,Navy,American,7,1,0,0.0,0,0.0,0,0,,0,0.0,1,0,0.0,0,,justin-smith-9
1216,Keyshawn Helton,Florida State,ACC,9,1,0,0.0,0,0.0,14,119,8.5,2,13.2,15,119,7.9,2,,keyshawn-helton-1
1217,Kylen Granson,SMU,American,10,1,0,0.0,0,0.0,35,536,15.3,5,53.6,36,536,14.9,5,,kylen-granson-1
1218,Matthew Downing,TCU,Big 12,4,11,0,0.0,0,0.0,0,0,,0,0.0,11,0,0.0,0,,matthew-downing-1
1219,Monte Pottebaum,Iowa,Big Ten,8,1,0,0.0,0,0.0,3,39,13.0,0,4.9,4,39,9.8,0,,monte-pottebaum-1
1220,Nate Cox,Nevada,MWC,8,1,0,0.0,0,0.0,0,0,,0,0.0,1,0,0.0,0,,nate-cox-1
1221,Ramaud Chiaokhiao-Bowman,Northwestern,Big Ten,9,1,0,0.0,0,0.0,41,508,12.4,5,56.4,42,508,12.1,5,,ramaud-chiaokhiao-bowman-1
1222,Ryan Hilinski,South Carolina,SEC,2,2,0,0.0,0,0.0,0,0,,0,0.0,2,0,0.0,0,,ryan-hilinski-1
1223,Shameen Jones,Rutgers,Big Ten,9,2,0,0.0,0,0.0,34,378,11.1,3,42.0,36,378,10.5,3,,shameen-jones-1
1224,Skyy Moore,Western Michigan,MAC,5,1,0,0.0,0,0.0,25,388,15.5,3,77.6,26,388,14.9,3,,skyy-moore-1
1225,Tamorrion Terry,Florida State,ACC,6,2,0,0.0,0,0.0,23,289,12.6,1,48.2,25,289,11.6,1,,tamorrion-terry-1
1226,Tayvian Cunningham,Arizona,Pac-12,4,1,0,0.0,0,0.0,9,139,15.4,1,34.8,10,139,13.9,1,,tayvian-cunningham-1
1227,Willie Eldridge,UTEP,CUSA,3,5,0,0.0,0,0.0,1,-1,-1.0,0,-0.3,6,-1,-0.2,0,,willie-eldridge-1
1228,Ahmarean Brown,Georgia Tech,ACC,7,2,-1,-0.5,1,-0.1,11,183,16.6,1,26.1,13,182,14.0,2,,ahmarean-brown-1
1229,Darius Ocean,Western Kentucky,CUSA,1,1,-1,-1.0,0,-1.0,0,0,,0,0.0,1,-1,-1.0,0,,darius-ocean-1
1230,Dimitri Stanley,Colorado,Pac-12,6,1,-1,-1.0,0,-0.2,20,335,16.8,1,55.8,21,334,15.9,1,,dimitri-stanley-1
1231,Eric Wilson Jr.,Florida International,CUSA,4,5,-1,-0.2,0,-0.3,0,0,,0,0.0,5,-1,-0.2,0,,eric-wilson-jr-1
1232,Jesse Matthews,San Diego State,MWC,8,1,-1,-1.0,0,-0.1,24,326,13.6,1,40.8,25,325,13.0,1,,jesse-matthews-1
1233,Joshua Moore,Texas,Big 12,10,1,-1,-1.0,0,-0.1,30,472,15.7,9,47.2,31,471,15.2,9,,joshua-moore-2
1234,Justin Prince,UTEP,CUSA,8,1,-1,-1.0,0,-0.1,0,0,,0,0.0,1,-1,-1.0,0,,justin-prince-1
1235,Lorenzo Dorr,West Virginia,Big 12,6,2,-1,-0.5,0,-0.2,0,0,,0,0.0,2,-1,-0.5,0,,lorenzo-dorr-1
1236,Malik Hornsby,Arkansas,SEC,1,2,-1,-0.5,0,-1.0,0,0,,0,0.0,2,-1,-0.5,0,,malik-hornsby-1
1237,Malik Rodgers,Tulsa,American,6,1,-1,-1.0,0,-0.2,7,85,12.1,0,14.2,8,84,10.5,0,,malik-rodgers-1
1238,Mitch Griffis,Wake Forest,ACC,4,2,-1,-0.5,0,-0.3,0,0,,0,0.0,2,-1,-0.5,0,,mitch-griffis-1
1239,Neil Pau'u,BYU,Ind,12,5,-1,-0.2,0,-0.1,45,603,13.4,4,50.3,50,602,12.0,4,,neil-pauu-1
1240,Prestron Jelen,Minnesota,Big Ten,7,1,-1,-1.0,0,-0.1,0,0,,0,0.0,1,-1,-1.0,0,,prestron-jelen-1
1241,Sam Hartman,Wake Forest,ACC,9,63,-1,0.0,2,-0.1,0,0,,0,0.0,63,-1,0.0,2,,sam-hartman-1
1242,Simi Fehoko,Stanford,Pac-12,6,1,-1,-1.0,0,-0.2,37,574,15.5,3,95.7,38,573,15.1,3,,simi-fehoko-1
1243,Arik Smith,Army,Ind,12,1,-2,-2.0,0,-0.2,0,0,,0,0.0,1,-2,-2.0,0,,arik-smith-1
1244,Austin Kendall,West Virginia,Big 12,2,2,-2,-1.0,0,-1.0,0,0,,0,0.0,2,-2,-1.0,0,,austin-kendall-1
1245,Changa Hodge,Virginia Tech,ACC,9,1,-2,-2.0,0,-0.2,3,25,8.3,0,2.8,4,23,5.8,0,,changa-hodge-1
1246,Chase Curtis,TCU,Big 12,3,1,-2,-2.0,0,-0.7,0,0,,0,0.0,1,-2,-2.0,0,,chase-curtis-1
1247,Chatarius Atwell,Louisville,ACC,9,2,-2,-1.0,1,-0.2,46,625,13.6,7,69.4,48,623,13.0,8,,chatarius-atwell-1
1248,Daniel Leconte,Florida Atlantic,CUSA,4,2,-2,-1.0,0,-0.5,0,0,,0,0.0,2,-2,-1.0,0,,daniel-leconte-1
1249,Derek Kerstetter,Texas,Big 12,9,1,-2,-2.0,0,-0.2,0,0,,0,0.0,1,-2,-2.0,0,,derek-kerstetter-1
1250,Devin Maddox,Toledo,MAC,6,1,-2,-2.0,0,-0.3,14,174,12.4,3,29.0,15,172,11.5,3,,devin-maddox-1
1251,Eric Najarian,Maryland,Big Ten,1,7,-2,-0.3,0,-2.0,0,0,,0,0.0,7,-2,-0.3,0,,eric-najarian-1
1252,Ethan Dedeaux,San Diego State,MWC,7,1,-2,-2.0,0,-0.3,5,36,7.2,1,5.1,6,34,5.7,1,,ethan-dedeaux-1
1253,Jyran Mitchell,Northern Illinois,MAC,6,2,-2,-1.0,0,-0.3,0,0,,0,0.0,2,-2,-1.0,0,,jyran-mitchell-1
1254,Ko Kieft,Minnesota,Big Ten,4,1,-2,-2.0,0,-0.5,2,29,14.5,1,7.3,3,27,9.0,1,,ko-kieft-1
1255,Malik Williams,Appalachian State,Sun Belt,11,1,-2,-2.0,0,-0.2,41,536,13.1,3,48.7,42,534,12.7,3,,malik-williams-2
1256,Ryan Harwell,Louisville,ACC,8,1,-2,-2.0,0,-0.3,0,0,,0,0.0,1,-2,-2.0,0,,ryan-harwell-1
1257,Sean Chambers,Wyoming,MWC,1,1,-2,-2.0,0,-2.0,0,0,,0,0.0,1,-2,-2.0,0,,sean-chambers-1
1258,Trea Shropshire,UAB,CUSA,9,1,-2,-2.0,0,-0.2,14,310,22.1,2,34.4,15,308,20.5,2,,trea-shropshire-1
1259,Trent Whittemore,Florida,SEC,9,1,-2,-2.0,0,-0.2,10,128,12.8,1,14.2,11,126,11.5,1,,trent-whittemore-1
1260,Daniel Sparks,Louisiana-Monroe,Sun Belt,10,1,-3,-3.0,0,-0.3,0,0,,0,0.0,1,-3,-3.0,0,,daniel-sparks-1
1261,Dexter Carter Jr.,Georgia Southern,Sun Belt,12,1,-3,-3.0,0,-0.3,3,99,33.0,1,8.3,4,96,24.0,1,,dexter-carter-jr-1
1262,Gavin Holmes,Baylor,Big 12,9,1,-3,-3.0,0,-0.3,33,244,7.4,1,27.1,34,241,7.1,1,,gavin-holmes-1
1263,Jace Ruder,North Carolina,ACC,3,4,-3,-0.8,0,-1.0,0,0,,0,0.0,4,-3,-0.8,0,,jace-ruder-1
1264,Jaelon Darden,North Texas,CUSA,9,1,-3,-3.0,0,-0.3,74,1190,16.1,19,132.2,75,1187,15.8,19,,jaelon-darden-1
1265,Jahleel Billingsley,Alabama,SEC,12,1,-3,-3.0,0,-0.3,18,287,15.9,3,23.9,19,284,14.9,3,,jahleel-billingsley-1
1266,Jared Smart,Hawaii,MWC,9,1,-3,-3.0,0,-0.3,36,320,8.9,1,35.6,37,317,8.6,1,,jared-smart-1
1267,Johnathan Bennett,Liberty,Ind,4,2,-3,-1.5,0,-0.8,0,0,,0,0.0,2,-3,-1.5,0,,johnathan-bennett-1
1268,Josh Downs,North Carolina,ACC,10,1,-3,-3.0,0,-0.3,7,119,17.0,3,11.9,8,116,14.5,3,,josh-downs-2
1269,Logan Holgorsen,Houston,American,4,2,-3,-1.5,0,-0.8,0,0,,0,0.0,2,-3,-1.5,0,,logan-holgorsen-1
1270,Max Duffy,Kentucky,SEC,9,1,-3,-3.0,0,-0.3,0,0,,0,0.0,1,-3,-3.0,0,,max-duffy-1
1271,Mycah Pittman,Oregon,Pac-12,5,2,-3,-1.5,0,-0.6,8,123,15.4,0,24.6,10,120,12.0,0,,mycah-pittman-1
1272,Renard Bell,Washington State,Pac-12,4,1,-3,-3.0,0,-0.8,33,337,10.2,2,84.3,34,334,9.8,2,,renard-bell-1
1273,Samuel Emilus,Massachusetts,Ind,4,2,-3,-1.5,0,-0.8,17,163,9.6,1,40.8,19,160,8.4,1,,samuel-emilus-1
1274,Andre Collins Jr.,Nevada-Las Vegas,MWC,1,2,-4,-2.0,0,-4.0,3,34,11.3,0,34.0,5,30,6.0,0,,andre-collins-jr-1
1275,Bernardo Rodriguez,North Texas,CUSA,10,1,-4,-4.0,0,-0.4,0,0,,0,0.0,1,-4,-4.0,0,,bernardo-rodriguez-1
1276,Brendon Clark,Notre Dame,ACC,1,1,-4,-4.0,0,-4.0,0,0,,0,0.0,1,-4,-4.0,0,,brendon-clark-1
1277,Garrett Curran,Boise State,MWC,7,1,-4,-4.0,0,-0.6,0,0,,0,0.0,1,-4,-4.0,0,,garrett-curran-1
1278,Jahquez Evans,South Florida,American,5,2,-4,-2.0,0,-0.8,0,0,,0,0.0,2,-4,-2.0,0,,jahquez-evans-1
1279,Jalon Calhoun,Duke,ACC,11,1,-4,-4.0,0,-0.4,39,349,8.9,2,31.7,40,345,8.6,2,,jalon-calhoun-1
1280,Jamaal Bell,Nevada,MWC,9,1,-4,-4.0,0,-0.4,3,37,12.3,1,4.1,4,33,8.3,1,,jamaal-bell-1
1281,Jawon Pass,Louisville,ACC,3,3,-4,-1.3,0,-1.3,0,0,,0,0.0,3,-4,-1.3,0,,jawon-pass-1
1282,Latrell Williams,South Florida,American,9,1,-4,-4.0,0,-0.4,22,260,11.8,0,28.9,23,256,11.1,0,,latrell-williams-1
1283,Luke Logan,Ole Miss,SEC,10,1,-4,-4.0,0,-0.4,0,0,,0,0.0,1,-4,-4.0,0,,luke-logan-1
1284,Makari Pruitt,Georgia State,Sun Belt,1,3,-4,-1.3,0,-4.0,0,0,,0,0.0,3,-4,-1.3,0,,makari-pruitt-1
1285,Michael Owusu,Vanderbilt,SEC,7,1,-4,-4.0,0,-0.6,0,0,,0,0.0,1,-4,-4.0,0,,michael-owusu-1
1286,Romeo Doubs,Nevada,MWC,9,1,-4,-4.0,0,-0.4,58,1002,17.3,9,111.3,59,998,16.9,9,,romeo-doubs-1
1287,Spencer Petras,Iowa,Big Ten,8,32,-4,-0.1,2,-0.5,0,0,,1,0.0,32,-4,-0.1,3,,spencer-petras-1
1288,T.J. Deshields,Akron,MAC,2,2,-4,-2.0,0,-2.0,0,0,,0,0.0,2,-4,-2.0,0,,tj-deshields-1
1289,Bryson Lucero,UAB,CUSA,7,8,-5,-0.6,0,-0.7,0,0,,0,0.0,8,-5,-0.6,0,,bryson-lucero-1
1290,Dontae Fleming,Louisiana,Sun Belt,9,1,-5,-5.0,0,-0.6,12,190,15.8,1,21.1,13,185,14.2,1,,dontae-fleming-1
1291,Jamarye Joiner,Arizona,Pac-12,5,2,-5,-2.5,0,-1.0,12,111,9.3,1,22.2,14,106,7.6,1,,jamarye-joiner-1
1292,Keric Wheatfall,Fresno State,MWC,5,1,-5,-5.0,0,-1.0,23,363,15.8,1,72.6,24,358,14.9,1,,keric-wheatfall-1
1293,Anthony Schwartz,Auburn,SEC,10,4,-6,-1.5,0,-0.6,54,636,11.8,3,63.6,58,630,10.9,3,,anthony-schwartz-1
1294,Brian Dooley,Eastern Michigan,MAC,6,1,-6,-6.0,0,-1.0,0,0,,0,0.0,1,-6,-6.0,0,,brian-dooley-1
1295,Chandler Fields,Louisiana,Sun Belt,2,1,-6,-6.0,0,-3.0,0,0,,0,0.0,1,-6,-6.0,0,,chandler-fields-1
1296,Chris Katrenick,Duke,ACC,1,3,-6,-2.0,0,-6.0,0,0,,0,0.0,3,-6,-2.0,0,,chris-katrenick-1
1297,Gary Bryant Jr.,USC,Pac-12,5,1,-6,-6.0,0,-1.2,7,51,7.3,0,10.2,8,45,5.6,0,,gary-bryant-jr-1
1298,Hank Bachmeier,Boise State,MWC,5,27,-6,-0.2,2,-1.2,0,0,,0,0.0,27,-6,-0.2,2,,hank-bachmeier-1
1299,Jaylen Gipson,Texas State,Sun Belt,3,2,-6,-3.0,0,-2.0,0,0,,0,0.0,2,-6,-3.0,0,,jaylen-gipson-1
1300,Jimmy Calloway,Tennessee,SEC,8,1,-6,-6.0,0,-0.8,2,20,10.0,0,2.5,3,14,4.7,0,,jimmy-calloway-1
1301,Jouvensly Bazil,Washington State,Pac-12,4,1,-6,-6.0,0,-1.5,0,0,,0,0.0,1,-6,-6.0,0,,jouvensly-bazil-1
1302,Michael Young,Cincinnati,American,10,1,-6,-6.0,0,-0.6,29,332,11.4,3,33.2,30,326,10.9,3,,michael-young-4
1303,Thayer Thomas,North Carolina State,ACC,12,1,-6,-6.0,0,-0.5,42,529,12.6,6,44.1,43,523,12.2,6,,thayer-thomas-1
1304,Tyrell Alexander,Vanderbilt,SEC,9,1,-6,-6.0,0,-0.7,2,11,5.5,0,1.2,3,5,1.7,0,,tyrell-alexander-1
1305,Hunter Helms,Clemson,ACC,3,2,-7,-3.5,0,-2.3,0,0,,0,0.0,2,-7,-3.5,0,,hunter-helms-1
1306,Tyler Van Dyke,Miami (FL),ACC,2,1,-7,-7.0,0,-3.5,0,0,,0,0.0,1,-7,-7.0,0,,tyler-van-dyke-1
1307,Adam Krumholz,Wisconsin,Big Ten,3,1,-8,-8.0,0,-2.7,3,47,15.7,0,15.7,4,39,9.8,0,,adam-krumholz-1
1308,Craig Burt Jr.,Western Kentucky,CUSA,11,1,-8,-8.0,0,-0.7,23,166,7.2,2,15.1,24,158,6.6,2,,craig-burt-jr-1
1309,Dannis Jackson,Ole Miss,SEC,10,1,-8,-8.0,0,-0.8,0,0,,0,0.0,1,-8,-8.0,0,,dannis-jackson-1
1310,Arian Smith,Georgia,SEC,4,1,-9,-9.0,0,-2.3,2,86,43.0,1,21.5,3,77,25.7,1,,arian-smith-1
1311,Beau Allen,Kentucky,SEC,2,2,-9,-4.5,0,-4.5,0,0,,0,0.0,2,-9,-4.5,0,,beau-allen-2
1312,Ben Finley,North Carolina State,ACC,1,2,-9,-4.5,0,-9.0,0,0,,0,0.0,2,-9,-4.5,0,,ben-finley-1
1313,Bryson Smith,Houston,American,7,3,-9,-3.0,0,-1.3,16,173,10.8,2,24.7,19,164,8.6,2,,bryson-smith-1
1314,Connor Riddle,Boise State,MWC,6,1,-9,-9.0,0,-1.5,0,0,,0,0.0,1,-9,-9.0,0,,connor-riddle-1
1315,Davis Beville,Pitt,ACC,6,4,-9,-2.3,0,-1.5,0,0,,0,0.0,4,-9,-2.3,0,,davis-beville-1
1316,Eric Miller,Purdue,Big Ten,6,1,-9,-9.0,0,-1.5,0,0,,0,0.0,1,-9,-9.0,0,,eric-miller-6
1317,Jordan Yates,Georgia Tech,ACC,3,4,-9,-2.3,0,-3.0,0,0,,0,0.0,4,-9,-2.3,0,,jordan-yates-1
1318,Landon Wolf,Oklahoma State,Big 12,11,1,-9,-9.0,0,-0.8,24,229,9.5,1,20.8,25,220,8.8,1,,landon-wolf-1
1319,Tavares Kelly,Virginia,ACC,5,2,-9,-4.5,0,-1.8,9,38,4.2,0,7.6,11,29,2.6,0,,tavares-kelly-1
1320,Tyleek Collins,Nevada-Las Vegas,MWC,5,5,-9,-1.8,0,-1.8,12,146,12.2,2,29.2,17,137,8.1,2,,tyleek-collins-1
1321,Wiley Green,Rice,CUSA,1,4,-9,-2.3,0,-9.0,0,0,,0,0.0,4,-9,-2.3,0,,wiley-green-1
1322,Aaron Allen,Louisiana Tech,CUSA,10,17,-10,-0.6,0,-1.0,0,0,,0,0.0,17,-10,-0.6,0,,aaron-allen-1
1323,Brady Cook,Missouri,SEC,3,1,-10,-10.0,0,-3.3,0,0,,0,0.0,1,-10,-10.0,0,,brady-cook-1
1324,D.J. Stubbs,Liberty,Ind,11,2,-10,-5.0,0,-0.9,38,523,13.8,3,47.5,40,513,12.8,3,,dj-stubbs-1
1325,Evan Conley,Louisville,ACC,4,1,-10,-10.0,0,-2.5,0,0,,0,0.0,1,-10,-10.0,0,,evan-conley-1
1326,Theo Wease,Oklahoma,Big 12,11,1,-10,-10.0,0,-0.9,37,530,14.3,4,48.2,38,520,13.7,4,,theo-wease-1
1327,Trad Beatty,Temple,American,2,10,-10,-1.0,0,-5.0,0,0,,0,0.0,10,-10,-1.0,0,,trad-beatty-1
1328,Trent Schneider,South Florida,American,8,1,-10,-10.0,0,-1.3,0,0,,0,0.0,1,-10,-10.0,0,,trent-schneider-1
1329,Cameron Rising,Utah,Pac-12,1,1,-11,-11.0,0,-11.0,0,0,,0,0.0,1,-11,-11.0,0,,cameron-rising-1
1330,James Blackman,Florida State,ACC,4,18,-11,-0.6,0,-2.8,0,0,,0,0.0,18,-11,-0.6,0,,james-blackman-1
1331,Lance Legendre,Maryland,Big Ten,3,6,-11,-1.8,0,-3.7,0,0,,0,0.0,6,-11,-1.8,0,,lance-legendre-1
1332,Jai'ave Magalei,Louisiana,Sun Belt,1,1,-12,-12.0,0,-12.0,0,0,,0,0.0,1,-12,-12.0,0,,jaiave-magalei-1
1333,Ethan Bullock,Oklahoma State,Big 12,2,6,-13,-2.2,0,-6.5,0,0,,0,0.0,6,-13,-2.2,0,,ethan-bullock-1
1334,Joshua Cephus,UTSA,CUSA,12,2,-13,-6.5,0,-1.1,58,547,9.4,5,45.6,60,534,8.9,5,,joshua-cephus-1
1335,Katravis Marsh,South Florida,American,4,4,-13,-3.3,0,-3.3,0,0,,0,0.0,4,-13,-3.3,0,,katravis-marsh-1
1336,Luke Akers,UCLA,Pac-12,7,1,-13,-13.0,0,-1.9,0,0,,0,0.0,1,-13,-13.0,0,,luke-akers-1
1337,Tate Rodemaker,Florida State,ACC,4,8,-13,-1.6,0,-3.3,0,0,,0,0.0,8,-13,-1.6,0,,tate-rodemaker-1
1338,Daniel Richardson,Central Michigan,MAC,5,14,-14,-1.0,1,-2.8,0,0,,0,0.0,14,-14,-1.0,1,,daniel-richardson-1
1339,Geordon Porter,Arizona State,Pac-12,4,1,-14,-14.0,0,-3.5,5,120,24.0,1,30.0,6,106,17.7,1,,geordon-porter-1
1340,Javonis Isaac,Arkansas State,Sun Belt,11,1,-14,-14.0,0,-1.3,0,0,,0,0.0,1,-14,-14.0,0,,javonis-isaac-1
1341,JD Head,Louisiana Tech,CUSA,2,2,-14,-7.0,0,-7.0,0,0,,0,0.0,2,-14,-7.0,0,,jd-head-1
1342,Tanner Mordecai,Oklahoma,Big 12,4,11,-14,-1.3,0,-3.5,0,0,,0,0.0,11,-14,-1.3,0,,tanner-mordecai-1
1343,Keke Chism,Missouri,SEC,9,1,-15,-15.0,0,-1.7,35,458,13.1,1,50.9,36,443,12.3,1,,keke-chism-1
1344,Miles Kendrick,Kansas,Big 12,7,42,-15,-0.4,0,-2.1,0,0,,0,0.0,42,-15,-0.4,0,,miles-kendrick-1
1345,Rome Odunze,Washington,Pac-12,4,3,-16,-5.3,0,-4.0,6,72,12.0,0,18.0,9,56,6.2,0,,rome-odunze-1
1346,Tristan Gebbia,Oregon State,Pac-12,4,19,-16,-0.8,2,-4.0,1,8,8.0,1,2.0,20,-8,-0.4,3,,tristan-gebbia-1
1347,Leroy Deshazor,Arkansas State,Sun Belt,7,1,-17,-17.0,0,-2.4,1,7,7.0,0,1.0,2,-10,-5.0,0,,leroy-deshazor-1
1348,Chris Ferguson,Liberty,Ind,6,4,-18,-4.5,0,-3.0,0,0,,0,0.0,4,-18,-4.5,0,,chris-ferguson-3
1349,Shane Illingworth,Oklahoma State,Big 12,4,12,-18,-1.5,0,-4.5,0,0,,0,0.0,12,-18,-1.5,0,,shane-illingworth-1
1350,Jordan Weeks,UTSA,CUSA,2,8,-19,-2.4,0,-9.5,0,0,,0,0.0,8,-19,-2.4,0,,jordan-weeks-1
1351,Nick Ast,Kansas State,Big 12,3,6,-19,-3.2,0,-6.3,0,0,,0,0.0,6,-19,-3.2,0,,nick-ast-1
1352,Bailey Hockman,North Carolina State,ACC,10,58,-22,-0.4,3,-2.2,1,31,31.0,1,3.1,59,9,0.2,4,,bailey-hockman-1
1353,Bryce Young,Alabama,SEC,8,9,-23,-2.6,0,-2.9,0,0,,0,0.0,9,-23,-2.6,0,,bryce-young-1
1354,JaCobian Morgan,Syracuse,ACC,4,12,-25,-2.1,0,-6.3,0,0,,0,0.0,12,-25,-2.1,0,,jacobian-morgan-1
1355,Max Bortenschlager,Florida International,CUSA,5,10,-25,-2.5,0,-5.0,0,0,,0,0.0,10,-25,-2.5,0,,max-bortenschlager-1
1356,Michael Collins,Rice,CUSA,3,30,-25,-0.8,0,-8.3,0,0,,0,0.0,30,-25,-0.8,0,,michael-collins-4
1357,Harrison Bailey,Tennessee,SEC,6,23,-28,-1.2,0,-4.7,0,0,,0,0.0,23,-28,-1.2,0,,harrison-bailey-1
1358,Gavin Hardison,UTEP,CUSA,7,25,-32,-1.3,0,-4.6,0,0,,0,0.0,25,-32,-1.3,0,,gavin-hardison-1
1359,Connor Bowler,Charlotte,CUSA,6,1,-33,-33.0,0,-5.5,0,0,,0,0.0,1,-33,-33.0,0,,connor-bowler-1
1360,Tanner Morgan,Minnesota,Big Ten,7,25,-35,-1.4,0,-5.0,0,0,,0,0.0,25,-35,-1.4,0,,tanner-morgan-2
1361,Myles Brennan,LSU,SEC,3,17,-36,-2.1,0,-12.0,0,0,,0,0.0,17,-36,-2.1,0,,myles-brennan-1
1362,Wesley French,Western Michigan,MAC,6,1,-36,-36.0,0,-6.0,0,0,,0,0.0,1,-36,-36.0,0,,wesley-french-1
1363,Shawn Robinson,Missouri,SEC,5,11,-39,-3.5,0,-7.8,1,-12,-12.0,0,-2.4,12,-51,-4.3,0,,shawn-robinson-2
1364,Nick Starkel,San Jose State,MWC,8,13,-40,-3.1,0,-5.0,0,0,,0,0.0,13,-40,-3.1,0,,nick-starkel-1
1365,Will Rogers,Mississippi State,SEC,9,30,-41,-1.4,1,-4.6,0,0,,0,0.0,30,-41,-1.4,1,,will-rogers-1
1366,Zach Gibson,Akron,MAC,6,48,-44,-0.9,0,-7.3,0,0,,0,0.0,48,-44,-0.9,0,,zach-gibson-1
1367,Joey Yellen,Pitt,ACC,6,5,-45,-9.0,0,-7.5,0,0,,0,0.0,5,-45,-9.0,0,,joey-yellen-1
1368,Ken Seals,Vanderbilt,SEC,9,41,-52,-1.3,0,-5.8,0,0,,0,0.0,41,-52,-1.3,0,,ken-seals-1
1369,Kedon Slovis,USC,Pac-12,6,23,-57,-2.5,0,-9.5,0,0,,0,0.0,23,-57,-2.5,0,,kedon-slovis-1
1370,Jacob Free,Troy,Sun Belt,6,14,-58,-4.1,1,-9.7,0,0,,0,0.0,14,-58,-4.1,1,,jacob-free-1
1371,Luke Anthony,Louisiana Tech,CUSA,9,49,-58,-1.2,1,-6.4,0,0,,0,0.0,49,-58,-1.2,1,,luke-anthony-1
1372,Ross Bowers,Northern Illinois,MAC,6,20,-59,-3.0,0,-9.8,0,0,,0,0.0,20,-59,-3.0,0,,ross-bowers-1
1373,Zach Smith,Tulsa,American,9,36,-62,-1.7,0,-6.9,0,0,,0,0.0,36,-62,-1.7,0,,zach-smith-6
1374,Aidan O'Connell,Purdue,Big Ten,3,12,-64,-5.3,0,-21.3,0,0,,0,0.0,12,-64,-5.3,0,,aidan-oconnell-1
1375,Rex Culpepper,Syracuse,ACC,10,26,-64,-2.5,0,-6.4,0,0,,0,0.0,26,-64,-2.5,0,,rex-culpepper-1
1376,K.J. Costello,Mississippi State,SEC,6,24,-65,-2.7,0,-10.8,0,0,,0,0.0,24,-65,-2.7,0,,kj-costello-1
1377,Collin Hill,South Carolina,SEC,8,43,-66,-1.5,4,-8.3,2,-14,-7.0,0,-1.8,45,-80,-1.8,4,,collin-hill-1
1378,Gunnar Watson,Troy,Sun Belt,9,30,-66,-2.2,0,-7.3,0,0,,0,0.0,30,-66,-2.2,0,,gunnar-watson-1
1379,JT Daniels,Georgia,SEC,4,10,-71,-7.1,0,-17.8,0,0,,0,0.0,10,-71,-7.1,0,,jt-daniels-1
1380,Stone Norton,Florida International,CUSA,5,17,-71,-4.2,0,-14.2,0,0,,0,0.0,17,-71,-4.2,0,,stone-norton-1
1381,Carson Strong,Nevada,MWC,9,33,-95,-2.9,0,-10.6,0,0,,0,0.0,33,-95,-2.9,0,,carson-strong-1
1382,Jarret Doege,West Virginia,Big 12,10,40,-101,-2.5,2,-10.1,1,-9,-9.0,0,-0.9,41,-110,-2.7,2,,jarret-doege-1