Rk,Player,Team,Conf,G,Att,Yds,Y/A,TD,Y/G,Rec,Yds,Y/R,TD,Y/G,Plays,Yds,Avg,TD,Awards,-9999
1,Chuba Hubbard*,Oklahoma State,Big 12,13,328,2094,6.4,21,161.1,23,198,8.6,0,15.2,351,2292,6.5,21,H-8AA,chuba-hubbard-1
2,Malcolm Perry*,Navy,American,13,295,2017,6.8,21,155.2,0,0,,0,0.0,295,2017,6.8,21,,malcolm-perry-1
3,J.K. Dobbins*,Ohio State,Big Ten,14,301,2003,6.7,21,143.1,23,247,10.7,2,17.6,324,2250,6.9,23,H-6,jk-dobbins-1
4,Jonathan Taylor*,Wisconsin,Big Ten,14,320,2003,6.3,21,143.1,26,252,9.7,5,18.0,346,2255,6.5,26,H-5AA,jonathan-taylor-1
5,Jaret Patterson*,Buffalo,MAC,13,312,1799,5.8,19,138.4,13,209,16.1,1,16.1,325,2008,6.2,20,,jaret-patterson-1
6,AJ Dillon*,Boston College,ACC,13,318,1685,5.3,14,129.6,13,195,15.0,1,15.0,331,1880,5.7,15,,aj-dillon-1
7,Travis Etienne*,Clemson,ACC,15,207,1614,7.8,19,107.6,37,432,11.7,4,28.8,244,2046,8.4,23,H-9,travis-etienne-1
8,Javian Hawkins*,Louisville,ACC,13,264,1525,5.8,9,117.3,4,58,14.5,0,4.5,268,1583,5.9,9,,javian-hawkins-1
9,Darrynton Evans*,Appalachian State,Sun Belt,14,255,1480,5.8,18,105.7,21,198,9.4,5,14.1,276,1678,6.1,23,,darrynton-evans-1
10,LeVante Bellamy*,Western Michigan,MAC,13,266,1472,5.5,23,113.2,15,55,3.7,0,4.2,281,1527,5.4,23,,levante-bellamy-1
11,Lynn Bowden Jr.*,Kentucky,SEC,13,185,1468,7.9,13,112.9,30,348,11.6,1,26.8,215,1816,8.4,14,AA,lynn-bowden-jr-1
12,Kenny Gainwell*,Memphis,American,14,231,1459,6.3,13,104.2,51,610,12.0,3,43.6,282,2069,7.3,16,,kenny-gainwell-1
13,Tra Barnett*,Georgia State,Sun Belt,13,248,1453,5.9,12,111.8,16,69,4.3,0,5.3,264,1522,5.8,12,,tra-barnett-1
14,Zack Moss*,Utah,Pac-12,13,235,1416,6.0,15,108.9,28,388,13.9,2,29.8,263,1804,6.9,17,,zack-moss-1
15,Clyde Edwards-Helaire*,LSU,SEC,15,215,1414,6.6,16,94.3,55,453,8.2,1,30.2,270,1867,6.9,17,,clyde-edwards-helaire-1
16,Brenden Knox*,Marshall,CUSA,13,270,1387,5.1,11,106.7,14,129,9.2,0,9.9,284,1516,5.3,11,,brenden-knox-1
17,Kylin Hill*,Mississippi State,SEC,13,242,1350,5.6,10,103.8,18,180,10.0,1,13.8,260,1530,5.9,11,,kylin-hill-1
18,Jalen Hurts*,Oklahoma,Big 12,14,233,1298,5.6,20,92.7,2,25,12.5,1,1.8,235,1323,5.6,21,H-2,jalen-hurts-1
19,Josh Johnson,Louisiana-Monroe,Sun Belt,12,201,1298,6.5,11,108.2,13,122,9.4,0,10.2,214,1420,6.6,11,,josh-johnson-8
20,Xavier Jones*,SMU,American,13,244,1276,5.2,23,98.2,20,90,4.5,2,6.9,264,1366,5.2,25,,xavier-jones-2
21,Caleb Huntley,Ball State,MAC,12,248,1275,5.1,12,106.3,7,25,3.6,0,2.1,255,1300,5.1,12,,caleb-huntley-1
22,Michael Warren II*,Cincinnati,American,14,261,1265,4.8,14,90.4,21,153,7.3,2,10.9,282,1418,5.0,16,,michael-warren-ii-1
23,Xazavian Valladay*,Wyoming,MWC,12,247,1265,5.1,6,105.4,11,211,19.2,2,17.6,258,1476,5.7,8,,xazavian-valladay-1
24,Charles Williams,Nevada-Las Vegas,MWC,12,212,1257,5.9,11,104.8,7,54,7.7,0,4.5,219,1311,6.0,11,,charles-williams-8
25,Najee Harris*,Alabama,SEC,13,209,1224,5.9,13,94.2,27,304,11.3,7,23.4,236,1528,6.5,20,,najee-harris-1
26,CJ Verdell*,Oregon,Pac-12,14,197,1220,6.2,8,87.1,14,125,8.9,0,8.9,211,1345,6.4,8,,cj-verdell-1
27,D'Andre Swift*,Georgia,SEC,14,196,1218,6.2,7,87.0,24,216,9.0,1,15.4,220,1434,6.5,8,,dandre-swift-1
28,Gaej Walker*,Western Kentucky,CUSA,13,241,1208,5.0,8,92.9,24,140,5.8,0,10.8,265,1348,5.1,8,,gaej-walker-1
29,Bryant Koback,Toledo,MAC,12,195,1187,6.1,12,98.9,8,69,8.6,2,5.8,203,1256,6.2,14,,bryant-koback-1
30,Rodney Smith*,Minnesota,Big Ten,13,228,1163,5.1,8,89.5,7,70,10.0,0,5.4,235,1233,5.2,8,,rodney-smith-5
31,Elijah Mitchell*,Louisiana,Sun Belt,14,198,1147,5.8,16,81.9,10,70,7.0,1,5.0,208,1217,5.9,17,,elijah-mitchell-2
32,Cam Akers*,Florida State,ACC,11,231,1144,5.0,14,104.0,30,225,7.5,4,20.5,261,1369,5.2,18,,cam-akers-1
33,Rakeem Boyd,Arkansas,SEC,12,184,1133,6.2,8,94.4,19,160,8.4,0,13.3,203,1293,6.4,8,,rakeem-boyd-2
34,Jonathan Ward*,Central Michigan,MAC,12,183,1108,6.1,15,92.3,34,329,9.7,1,27.4,217,1437,6.6,16,,jonathan-ward-3
35,Jason Huntley,New Mexico State,Ind,12,154,1090,7.1,9,90.8,40,192,4.8,2,16.0,194,1282,6.6,11,,jason-huntley-1
36,C.J. Marable,Coastal Carolina,Sun Belt,12,204,1085,5.3,11,90.4,38,295,7.8,3,24.6,242,1380,5.7,14,,torrance-marable-1
37,Eno Benjamin*,Arizona State,Pac-12,12,253,1083,4.3,10,90.3,42,347,8.3,2,28.9,295,1430,4.8,12,,eno-benjamin-1
38,Ben LeMay*,Charlotte,CUSA,11,193,1082,5.6,9,98.4,19,242,12.7,4,22.0,212,1324,6.2,13,,ben-lemay-1
39,Kobe Lewis*,Central Michigan,MAC,14,182,1074,5.9,12,76.7,23,164,7.1,0,11.7,205,1238,6.0,12,,kobe-lewis-1
40,Justin Henderson*,Louisiana Tech,CUSA,13,188,1062,5.6,15,81.7,24,200,8.3,1,15.4,212,1262,6.0,16,,justin-henderson-2
41,Pooka Williams,Kansas,Big 12,11,203,1061,5.2,3,96.5,27,214,7.9,2,19.5,230,1275,5.5,5,,pooka-williams-1
42,Joshua Kelley,UCLA,Pac-12,11,229,1060,4.6,12,96.4,11,71,6.5,1,6.5,240,1131,4.7,13,,joshua-kelley-1
43,Asher O'Hara,Middle Tennessee State,CUSA,12,199,1058,5.3,9,88.2,0,-5,,0,-0.4,199,1053,5.3,9,,asher-ohara-1
44,Tra Minter,South Alabama,Sun Belt,12,193,1057,5.5,5,88.1,32,209,6.5,0,17.4,225,1266,5.6,5,,tra-minter-1
45,Kadin Remsberg*,Air Force,MWC,13,181,1050,5.8,8,80.8,3,24,8.0,0,1.8,184,1074,5.8,8,,kadin-remsberg-1
46,Shamari Brooks,Tulsa,American,12,227,1046,4.6,6,87.2,9,49,5.4,1,4.1,236,1095,4.6,7,,shamari-brooks-1
47,Frankie Hickson*,Liberty,Ind,13,187,1041,5.6,12,80.1,11,96,8.7,1,7.4,198,1137,5.7,13,,frankie-hickson-1
48,Kevin Marks*,Buffalo,MAC,13,227,1035,4.6,8,79.6,12,41,3.4,0,3.2,239,1076,4.5,8,,kevin-marks-1
49,Ke'Shawn Vaughn,Vanderbilt,SEC,12,198,1028,5.2,9,85.7,29,286,9.9,1,23.8,227,1314,5.8,10,,keshawn-vaughn-1
50,John Rhys Plumlee,Ole Miss,SEC,9,154,1023,6.6,12,113.7,0,0,,0,0.0,154,1023,6.6,12,,john-rhys-plumlee-1
51,Tre Harbison,Northern Illinois,MAC,11,230,1021,4.4,8,92.8,6,47,7.8,0,4.3,236,1068,4.5,8,,tre-harbison-1
52,Salvon Ahmed*,Washington,Pac-12,12,188,1020,5.4,11,85.0,16,84,5.3,0,7.0,204,1104,5.4,11,,salvon-ahmed-1
53,George Holani*,Boise State,MWC,14,192,1014,5.3,7,72.4,26,206,7.9,3,14.7,218,1220,5.6,10,,george-holani-1
54,Kevin Mensah,Connecticut,American,12,226,1013,4.5,9,84.4,8,91,11.4,0,7.6,234,1104,4.7,9,,kevin-mensah-1
55,Kennedy Brooks*,Oklahoma,Big 12,13,155,1011,6.5,6,77.8,10,79,7.9,0,6.1,165,1090,6.6,6,,kennedy-brooks-1
56,Michael Carter*,North Carolina,ACC,13,177,1003,5.7,3,77.2,21,154,7.3,2,11.8,198,1157,5.8,5,,michael-carter-5
57,Elijah Collins*,Michigan State,Big Ten,13,222,988,4.5,5,76.0,15,99,6.6,0,7.6,237,1087,4.6,5,,elijah-collins-1
58,Sincere McCormick,UTSA,CUSA,12,177,983,5.6,8,81.9,24,194,8.1,1,16.2,201,1177,5.9,9,,sincere-mccormick-1
59,Isaiah Spiller*,Texas A&M,SEC,13,174,946,5.4,10,72.8,29,203,7.0,0,15.6,203,1149,5.7,10,,isaiah-spiller-1
60,Re'Mahn Davis*,Temple,American,12,193,936,4.8,8,78.0,15,181,12.1,2,15.1,208,1117,5.4,10,,remahn-davis-1
61,Javonte Williams*,North Carolina,ACC,13,166,933,5.6,5,71.8,17,176,10.4,1,13.5,183,1109,6.1,6,,javonte-williams-1
62,Gerold Bright*,Utah State,MWC,13,182,921,5.1,9,70.8,35,230,6.6,1,17.7,217,1151,5.3,10,,gerold-bright-1
63,Christopher Brooks*,California,Pac-12,13,208,914,4.4,8,70.3,22,166,7.5,4,12.8,230,1080,4.7,12,,christopher-brooks-1
64,Miles Reed*,Hawaii,MWC,15,174,908,5.2,8,60.5,3,16,5.3,0,1.1,177,924,5.2,8,,miles-reed-1
65,DK Billingsley,Troy,Sun Belt,12,155,901,5.8,10,75.1,25,211,8.4,0,17.6,180,1112,6.2,10,,dk-billingsley-1
66,Jordan Mason,Georgia Tech,ACC,12,172,899,5.2,7,74.9,7,43,6.1,0,3.6,179,942,5.3,7,,jordan-mason-1
67,Ronnie Rivers,Fresno State,MWC,12,177,899,5.1,13,74.9,43,348,8.1,3,29.0,220,1247,5.7,16,,ronnie-rivers-1
68,Breece Hall*,Iowa State,Big 12,12,186,897,4.8,9,74.8,23,252,11.0,1,21.0,209,1149,5.5,10,,breece-hall-1
69,Journey Brown*,Penn State,Big Ten,13,129,890,6.9,12,68.5,15,134,8.9,1,10.3,144,1024,7.1,13,,journey-brown-1
70,Raymond Calais*,Louisiana,Sun Belt,14,117,886,7.6,6,63.3,10,67,6.7,1,4.8,127,953,7.5,7,,raymond-calais-1
71,Alex Fontenot,Colorado,Pac-12,11,185,874,4.7,5,79.5,27,122,4.5,0,11.1,212,996,4.7,5,,alex-fontenot-1
72,Art Pierce,Oregon State,Pac-12,12,146,873,6.0,6,72.8,23,169,7.3,1,14.1,169,1042,6.2,7,,art-pierce-1
73,O'Shaan Allison*,Ohio,MAC,12,138,869,6.3,6,72.4,11,76,6.9,0,6.3,149,945,6.3,6,,oshaan-allison-1
74,Anthony Jones*,Florida International,CUSA,12,187,867,4.6,9,72.3,10,123,12.3,2,10.3,197,990,5.0,11,,anthony-jones-8
75,Nathan Rourke*,Ohio,MAC,13,154,867,5.6,13,66.7,1,2,2.0,1,0.2,155,869,5.6,14,,nathan-rourke-1
76,Tony Jones Jr.*,Notre Dame,Ind,12,144,857,6.0,6,71.4,15,104,6.9,1,8.7,159,961,6.0,7,,tony-jones-jr-1
77,Bilal Ally,Massachusetts,Ind,12,166,853,5.1,7,71.1,7,32,4.6,0,2.7,173,885,5.1,7,,bilal-ally-1
78,Keaontay Ingram*,Texas,Big 12,13,144,853,5.9,7,65.6,29,242,8.3,3,18.6,173,1095,6.3,10,,keaontay-ingram-1
79,Tre Siggers,North Texas,CUSA,10,152,853,5.6,6,85.3,11,60,5.5,0,6.0,163,913,5.6,6,,tre-siggers-1
80,Moe Neal,Syracuse,ACC,12,170,846,5.0,7,70.5,29,242,8.3,0,20.2,199,1088,5.5,7,,moe-neal-1
81,Stevie Scott*,Indiana,Big Ten,11,178,845,4.7,10,76.8,26,211,8.1,1,19.2,204,1056,5.2,11,,stevie-scott-1
82,David Bailey*,Boston College,ACC,13,148,844,5.7,7,64.9,10,94,9.4,1,7.2,158,938,5.9,8,,david-bailey-4
83,Deshawn McClease*,Virginia Tech,ACC,13,177,843,4.8,7,64.8,11,70,6.4,0,5.4,188,913,4.9,7,,deshawn-mcclease-1
84,Cameron Scarlett,Stanford,Pac-12,12,201,840,4.2,7,70.0,25,240,9.6,0,20.0,226,1080,4.8,7,,cameron-scarlett-1
85,Taven Birdow*,Air Force,MWC,13,180,839,4.7,7,64.5,1,16,16.0,0,1.2,181,855,4.7,7,,taven-birdow-1
86,Ahmari Davis,New Mexico,MWC,9,140,832,5.9,7,92.4,3,63,21.0,0,7.0,143,895,6.3,7,,ahmari-davis-1
87,Larry Rountree III,Missouri,SEC,12,186,829,4.5,9,69.1,13,70,5.4,0,5.8,199,899,4.5,9,,larry-rountree-iii-1
88,Asim Rose*,Kentucky,SEC,13,149,826,5.5,6,63.5,11,67,6.1,0,5.2,160,893,5.6,6,,asim-rose-1
89,Wesley Kennedy III*,Georgia Southern,Sun Belt,9,119,824,6.9,11,91.6,10,92,9.2,0,10.2,129,916,7.1,11,,wesley-kennedy-iii-1
90,Darius Anderson,TCU,Big 12,12,151,823,5.5,6,68.6,22,128,5.8,0,10.7,173,951,5.5,6,,darius-anderson-1
91,Marcel Murray*,Arkansas State,Sun Belt,11,170,820,4.8,6,74.5,15,125,8.3,0,11.4,185,945,5.1,6,,marcel-murray-1
92,Trey Ragas*,Louisiana,Sun Belt,13,116,820,7.1,11,63.1,6,60,10.0,1,4.6,122,880,7.2,12,,trey-ragas-1
93,Max Borghi*,Washington State,Pac-12,13,127,817,6.4,11,62.8,86,597,6.9,5,45.9,213,1414,6.6,16,,max-borghi-1
94,Toa Taua*,Nevada,MWC,13,196,807,4.1,6,62.1,30,185,6.2,0,14.2,226,992,4.4,6,,toa-taua-1
95,J.D. King*,Georgia Southern,Sun Belt,12,185,804,4.3,8,67.0,2,14,7.0,0,1.2,187,818,4.4,8,,jd-king-1
96,Caleb Evans,Louisiana-Monroe,Sun Belt,12,140,794,5.7,12,66.2,0,0,,0,0.0,140,794,5.7,12,,caleb-evans-2
97,Chris Reynolds*,Charlotte,CUSA,13,153,791,5.2,6,60.8,1,28,28.0,0,2.2,154,819,5.3,6,,chris-reynolds-1
98,Master Teague*,Ohio State,Big Ten,13,135,789,5.8,4,60.7,4,60,15.0,0,4.6,139,849,6.1,4,,master-teague-1
99,Joshua Mack*,Liberty,Ind,13,133,774,5.8,7,59.5,13,177,13.6,0,13.6,146,951,6.5,7,,joshua-mack-1
100,Aston Walter,Rice,CUSA,11,145,771,5.3,8,70.1,11,48,4.4,2,4.4,156,819,5.3,10,,aston-walter-1
101,Bryce Perkins*,Virginia,ACC,14,227,769,3.4,11,54.9,0,0,,0,0.0,227,769,3.4,11,,bryce-perkins-1
102,SaRodorick Thompson,Texas Tech,Big 12,12,160,765,4.8,12,63.8,39,154,3.9,0,12.8,199,919,4.6,12,,sarodorick-thompson-1
103,JaTarvious Whitlow*,Auburn,SEC,11,156,763,4.9,10,69.4,6,106,17.7,0,9.6,162,869,5.4,10,,jatarvious-whitlow-1
104,Dedrick Mills,Nebraska,Big Ten,12,143,745,5.2,10,62.1,15,123,8.2,0,10.3,158,868,5.5,10,,dedrick-mills-1
105,Justin McMillan*,Tulane,American,13,169,745,4.4,12,57.3,1,27,27.0,0,2.1,170,772,4.5,12,,justin-mcmillan-1
106,Timothy Jackson*,Air Force,MWC,10,122,745,6.1,6,74.5,1,-2,-2.0,0,-0.2,123,743,6.0,6,,timothy-jackson-1
107,Zonovan Knight,North Carolina State,ACC,12,136,745,5.5,5,62.1,7,45,6.4,0,3.8,143,790,5.5,5,,zonovan-knight-1
108,Jaylon Bester*,Miami (OH),MAC,11,171,741,4.3,14,67.4,12,59,4.9,0,5.4,183,800,4.4,14,,jaylon-bester-1
109,Shakif Seymour,Toledo,MAC,12,154,741,4.8,5,61.8,16,124,7.8,1,10.3,170,865,5.1,6,,shakif-seymour-1
110,Shai Werts*,Georgia Southern,Sun Belt,11,170,740,4.4,5,67.3,0,0,,0,0.0,170,740,4.4,5,,shai-werts-1
111,James Gilbert*,Kansas State,Big 12,11,141,737,5.2,6,67.0,6,49,8.2,0,4.5,147,786,5.3,6,,james-gilbert-2
112,Javon Leake,Maryland,Big Ten,12,102,736,7.2,8,61.3,9,55,6.1,0,4.6,111,791,7.1,8,,javon-leake-1
113,Jamale Carothers*,Navy,American,10,111,734,6.6,14,73.4,4,105,26.3,2,10.5,115,839,7.3,16,,jamale-carothers-2
114,Isiah Pacheco,Rutgers,Big Ten,11,169,729,4.3,7,66.3,13,83,6.4,0,7.5,182,812,4.5,7,,isaih-pacheco-1
115,Otis Anderson*,UCF,American,13,113,726,6.4,5,55.8,31,365,11.8,3,28.1,144,1091,7.6,8,,otis-anderson-1
116,Walter Fletcher,Ball State,MAC,12,132,726,5.5,5,60.5,26,306,11.8,2,25.5,158,1032,6.5,7,,walter-fletcher-1
117,Zach Charbonnet*,Michigan,Big Ten,13,149,726,4.9,11,55.8,8,30,3.8,0,2.3,157,756,4.8,11,,zach-charbonnet-1
118,Jerrion Ealy,Ole Miss,SEC,12,104,722,6.9,6,60.2,20,172,8.6,1,14.3,124,894,7.2,7,,jerrion-ealy-1
119,J.J. Taylor,Arizona,Pac-12,11,148,721,4.9,5,65.5,32,289,9.0,0,26.3,180,1010,5.6,5,,jj-taylor-1
120,Shaq Vann*,Eastern Michigan,MAC,10,149,715,4.8,8,71.5,11,66,6.0,0,6.6,160,781,4.9,8,,shaq-vann-1
121,Malcolm Davidson*,Florida Atlantic,CUSA,11,102,711,7.0,9,64.6,4,46,11.5,0,4.2,106,757,7.1,9,,malcolm-davidson-1
122,Kelvin Hopkins Jr.,Army,Ind,11,138,710,5.1,7,64.5,0,0,,0,0.0,138,710,5.1,7,,kelvin-hopkins-jr-1
123,Dustin Crum*,Kent State,MAC,13,168,707,4.2,6,54.4,1,0,0.0,0,0.0,169,707,4.2,6,,dustin-crum-1
124,Marvin Kinsey,Colorado State,MWC,7,121,703,5.8,6,100.4,16,209,13.1,2,29.9,137,912,6.7,8,,marvin-kinsey-1
125,Deejay Dallas*,Miami (FL),ACC,10,115,693,6.0,8,69.3,14,140,10.0,2,14.0,129,833,6.5,10,,deejay-dallas-1
126,Jordan Cronkrite,South Florida,American,10,136,686,5.0,4,68.6,15,134,8.9,0,13.4,151,820,5.4,4,,jordan-cronkrite-1
127,Jermar Jefferson,Oregon State,Pac-12,9,142,685,4.8,8,76.1,9,85,9.4,2,9.4,151,770,5.1,10,,jermar-jefferson-1
128,Treyvon Hughes,UTEP,CUSA,12,167,682,4.1,12,56.8,1,2,2.0,0,0.2,168,684,4.1,12,,treyvon-hughes-1
129,Lamical Perine*,Florida,SEC,13,132,676,5.1,6,52.0,40,262,6.6,5,20.2,172,938,5.5,11,,lamical-perine-1
130,Napoleon Maxwell*,Florida International,CUSA,13,128,675,5.3,9,51.9,13,94,7.2,0,7.2,141,769,5.5,9,,napoleon-maxwell-1
131,Reggie Corbin*,Illinois,Big Ten,12,143,675,4.7,7,56.3,3,28,9.3,0,2.3,146,703,4.8,7,,reggie-corbin-1
132,Tavien Feaster,South Carolina,SEC,10,124,672,5.4,5,67.2,17,87,5.1,0,8.7,141,759,5.4,5,,tavien-feaster-1
133,Dan Ellington*,Georgia State,Sun Belt,13,160,668,4.2,6,51.4,0,0,,0,0.0,160,668,4.2,6,,dan-ellington-1
134,Sam Ehlinger*,Texas,Big 12,13,163,663,4.1,7,51.0,2,14,7.0,0,1.1,165,677,4.1,7,,sam-ehlinger-1
135,Connor Slomka,Army,Ind,12,149,658,4.4,8,54.8,0,0,,0,0.0,149,658,4.4,8,,connor-slomka-1
136,Travis Dye*,Oregon,Pac-12,14,106,658,6.2,0,47.0,16,159,9.9,1,11.4,122,817,6.7,1,,travis-dye-1
137,John Lovett*,Baylor,Big 12,14,103,655,6.4,5,46.8,8,66,8.3,0,4.7,111,721,6.5,5,,john-lovett-1
138,Ty Chandler*,Tennessee,SEC,13,135,655,4.9,3,50.4,13,63,4.8,0,4.8,148,718,4.9,3,,ty-chandler-1
139,Marcus Williams Jr.*,Appalachian State,Sun Belt,14,113,652,5.8,5,46.6,1,7,7.0,0,0.5,114,659,5.8,5,,marcus-williams-12
140,Desmond Ridder*,Cincinnati,American,13,144,650,4.5,5,50.0,0,0,,0,0.0,144,650,4.5,5,,desmond-ridder-1
141,Roschon Johnson*,Texas,Big 12,13,123,649,5.3,7,49.9,23,158,6.9,1,12.2,146,807,5.5,8,,roschon-johnson-1
142,De'Montre Tuggle*,Ohio,MAC,12,101,644,6.4,11,53.7,16,121,7.6,1,10.1,117,765,6.5,12,,demontre-tuggle-1
143,Deon Jackson,Duke,ACC,12,172,641,3.7,6,53.4,21,192,9.1,2,16.0,193,833,4.3,8,,deon-jackson-1
144,Tyler Goodson*,Iowa,Big Ten,13,134,638,4.8,5,49.1,24,166,6.9,0,12.8,158,804,5.1,5,,tyler-goodson-1
145,Lyn-J Dixon*,Clemson,ACC,15,104,635,6.1,6,42.3,14,121,8.6,0,8.1,118,756,6.4,6,,lyn-j-dixon-1
146,Drake Anderson,Northwestern,Big Ten,12,154,634,4.1,3,52.8,6,28,4.7,0,2.3,160,662,4.1,3,,drake-anderson-1
147,Adrian Killins*,UCF,American,12,87,629,7.2,7,52.4,8,120,15.0,1,10.0,95,749,7.9,8,,adrian-killins-1
148,Spencer Sanders*,Oklahoma State,Big 12,11,139,628,4.5,2,57.1,0,0,,0,0.0,139,628,4.5,2,,spencer-sanders-1
149,JaMycal Hasty*,Baylor,Big 12,14,109,627,5.8,7,44.8,25,184,7.4,0,13.1,134,811,6.1,7,,jamycal-hasty-1
150,Adrian Martinez,Nebraska,Big Ten,10,144,626,4.3,7,62.6,0,0,,0,0.0,144,626,4.3,7,,adrian-martinez-2
151,Hassan Haskins*,Michigan,Big Ten,13,121,622,5.1,4,47.8,6,40,6.7,0,3.1,127,662,5.2,4,,hassan-haskins-1
152,Cade Carney*,Wake Forest,ACC,11,158,620,3.9,5,56.4,7,28,4.0,0,2.5,165,648,3.9,5,,cade-carney-1
153,Kavosiey Smoke*,Kentucky,SEC,13,101,616,6.1,6,47.4,2,26,13.0,0,2.0,103,642,6.2,6,,kavosiey-smoke-1
154,Kyle Porter,Houston,American,11,130,616,4.7,3,56.0,13,128,9.8,1,11.6,143,744,5.2,4,,kyle-porter-1
155,Anthony McFarland,Maryland,Big Ten,11,114,614,5.4,8,55.8,17,126,7.4,1,11.5,131,740,5.6,9,,anthony-mcfarland-2
156,Bentavious Thompson*,UCF,American,12,87,604,6.9,8,50.3,5,25,5.0,0,2.1,92,629,6.8,8,,bentavious-thompson-1
157,Bentavious Thompson*,UCF,American,13,87,604,6.9,8,46.5,5,25,5.0,0,1.9,92,629,6.8,8,,bentavious-thompson-2
158,Mohamed Ibrahim*,Minnesota,Big Ten,11,114,604,5.3,7,54.9,3,13,4.3,0,1.2,117,617,5.3,7,,mohamed-ibrahim-1
159,Garrett Shrader*,Mississippi State,SEC,10,113,587,5.2,6,58.7,0,0,,0,0.0,113,587,5.2,6,,garrett-shrader-1
160,Tyre Shelton*,Miami (OH),MAC,14,108,587,5.4,2,41.9,13,78,6.0,0,5.6,121,665,5.5,2,,tyre-shelton-1
161,Jager Gardner*,Temple,American,11,141,585,4.1,5,53.2,8,48,6.0,0,4.4,149,633,4.2,5,,jager-gardner-1
162,Dre Brown*,Illinois,Big Ten,13,113,584,5.2,5,44.9,10,82,8.2,0,6.3,123,666,5.4,5,,dre-brown-1
163,Kenneth Walker III*,Wake Forest,ACC,13,98,579,5.9,4,44.5,3,17,5.7,0,1.3,101,596,5.9,4,,kenneth-walker-iii-1
164,Cam'ron Harris*,Miami (FL),ACC,13,114,576,5.1,5,44.3,16,118,7.4,1,9.1,130,694,5.3,6,,camron-harris-1
165,Sandon McCoy,Army,Ind,13,134,576,4.3,10,44.3,0,0,,0,0.0,134,576,4.3,10,,sandon-mccoy-1
166,Corey Dauphine*,Tulane,American,12,72,575,8.0,7,47.9,1,6,6.0,0,0.5,73,581,8.0,7,,corey-dauphine-1
167,Jamie Newman*,Wake Forest,ACC,12,180,574,3.2,6,47.8,0,0,,0,0.0,180,574,3.2,6,,jamie-newman-1
168,Nelson Smith*,Navy,American,13,116,571,4.9,7,43.9,0,0,,0,0.0,116,571,4.9,7,,nelson-smith-1
169,Will Matthews*,Kent State,MAC,8,123,570,4.6,3,71.3,7,70,10.0,0,8.8,130,640,4.9,3,,will-mathews-1
170,Jaylen Warren*,Utah State,MWC,12,112,569,5.1,5,47.4,15,182,12.1,0,15.2,127,751,5.9,5,,jaylen-warren-1
171,DeJon Packer,San Jose State,MWC,12,125,567,4.5,11,47.3,27,270,10.0,1,22.5,152,837,5.5,12,,dejon-packer-1
172,Sean Chambers*,Wyoming,MWC,8,90,567,6.3,10,70.9,0,0,,0,0.0,90,567,6.3,10,,sean-chambers-1
173,Spencer Brown*,UAB,CUSA,12,150,566,3.8,5,47.2,3,16,5.3,0,1.3,153,582,3.8,5,,spencer-brown-3
174,Mekhi Sargent*,Iowa,Big Ten,13,119,563,4.7,4,43.3,14,138,9.9,0,10.6,133,701,5.3,4,,mekhi-sargent-1
175,Trevor Lawrence*,Clemson,ACC,15,103,563,5.5,9,37.5,1,0,0.0,0,0.0,104,563,5.4,9,H-7,trevor-lawrence-1
176,Max Duggan,TCU,Big 12,12,130,555,4.3,6,46.3,0,0,,0,0.0,130,555,4.3,6,,max-duggan-1
177,Donald Hammond III*,Air Force,MWC,13,121,553,4.6,13,42.5,1,22,22.0,0,1.7,122,575,4.7,13,,donald-hammond-iii-1
178,Kevin Perkins*,Southern Mississippi,CUSA,13,103,547,5.3,3,42.1,7,46,6.6,0,3.5,110,593,5.4,3,,kevin-perkins-1
179,Destin Coates*,Georgia State,Sun Belt,11,82,546,6.7,7,49.6,7,60,8.6,0,5.5,89,606,6.8,7,,destin-coates-1
180,Ian Book*,Notre Dame,Ind,13,112,546,4.9,4,42.0,0,0,,0,0.0,112,546,4.9,4,,ian-book-1
181,Bryson Denley,Bowling Green,MAC,12,111,544,4.9,4,45.3,27,267,9.9,3,22.3,138,811,5.9,7,,bryson-denley-1
182,Scottie Phillips,Ole Miss,SEC,10,125,542,4.3,5,54.2,8,77,9.6,1,7.7,133,619,4.7,6,,scottie-phillips-1
183,De'Michael Harris*,Southern Mississippi,CUSA,12,113,541,4.8,5,45.1,34,346,10.2,3,28.8,147,887,6.0,8,,demichael-harris-1
184,Eric Gray*,Tennessee,SEC,13,101,539,5.3,4,41.5,13,115,8.8,1,8.8,114,654,5.7,5,,eric-gray-2
185,Sewo Olonilua,TCU,Big 12,12,134,537,4.0,8,44.8,24,114,4.8,1,9.5,158,651,4.1,9,,sewo-olonilua-1
186,Bryson Carroll,New Mexico,MWC,10,105,536,5.1,2,53.6,2,12,6.0,0,1.2,107,548,5.1,2,,bryson-carroll-1
187,Kai Locksley,UTEP,CUSA,11,126,535,4.2,5,48.6,0,0,,0,0.0,126,535,4.2,5,,kai-locksley-1
188,Christopher Rodriguez Jr.*,Kentucky,SEC,13,71,533,7.5,6,41.0,1,2,2.0,0,0.2,72,535,7.4,6,,christopher-rodriguez-jr-1
189,A.J. Davis*,Pitt,ACC,11,127,530,4.2,4,48.2,23,269,11.7,0,24.5,150,799,5.3,4,,aj-davis-4
190,A.J. Davis Jr.*,Pitt,ACC,11,127,530,4.2,4,48.2,23,269,11.7,0,24.5,150,799,5.3,4,,aj-davis-jr-1
191,Greg McCrae*,UCF,American,10,98,529,5.4,7,52.9,9,64,7.1,0,6.4,107,593,5.5,7,,greg-mccrae-1
192,Gerrid Doaks*,Cincinnati,American,12,100,526,5.3,5,43.8,8,70,8.8,1,5.8,108,596,5.5,6,,gerrid-doaks-1
193,Jordan Houston,North Carolina State,ACC,12,101,526,5.2,2,43.8,15,112,7.5,0,9.3,116,638,5.5,2,,jordan-houston-1
194,Davon Jones,Bowling Green,MAC,9,118,518,4.4,3,57.6,15,50,3.3,1,5.6,133,568,4.3,4,,davon-jones-1
195,Ke'Mon Freeman*,SMU,American,13,122,517,4.2,5,39.8,6,37,6.2,0,2.8,128,554,4.3,5,,kemon-freemon-1
196,Rhamondre Stevenson*,Oklahoma,Big 12,13,64,515,8.0,6,39.6,10,87,8.7,0,6.7,74,602,8.1,6,,rhamondre-stevenson-1
197,Snoop Conner,Ole Miss,SEC,12,81,512,6.3,5,42.7,6,60,10.0,0,5.0,87,572,6.6,5,,snoop-conner-1
198,Quentin Harris,Duke,ACC,12,160,510,3.2,7,42.5,0,0,,0,0.0,160,510,3.2,7,,quentin-harris-2
199,Vavae Malepeai*,USC,Pac-12,8,105,503,4.8,6,62.9,15,70,4.7,1,8.8,120,573,4.8,7,,vavae-malepeai-1
200,Hassan Hall*,Louisville,ACC,13,108,501,4.6,5,38.5,5,51,10.2,0,3.9,113,552,4.9,5,,hassan-hall-1
201,Juwan Washington*,San Diego State,MWC,9,150,500,3.3,2,55.6,17,100,5.9,2,11.1,167,600,3.6,4,,juwan-washington-1
202,Kellen Mond*,Texas A&M,SEC,13,126,500,4.0,8,38.5,0,0,,0,0.0,126,500,4.0,8,,kellen-mond-1
203,Richard Newton*,Washington,Pac-12,10,117,498,4.3,10,49.8,2,16,8.0,1,1.6,119,514,4.3,11,,richard-newton-1
204,Rico Dowdle,South Carolina,SEC,10,106,498,4.7,4,49.8,22,167,7.6,0,16.7,128,665,5.2,4,,rico-dowdle-1
205,Lowell Narcisse,UTSA,CUSA,11,118,492,4.2,4,44.7,0,0,,0,0.0,118,492,4.2,4,,lowell-narcisse-1
206,Brian Herrien*,Georgia,SEC,12,103,490,4.8,6,40.8,16,110,6.9,1,9.2,119,600,5.0,7,,brian-herrien-1
207,Christian Gibson,New Mexico State,Ind,12,99,489,4.9,3,40.8,10,54,5.4,0,4.5,109,543,5.0,3,,christian-gibson-1
208,Caleb Twyford,Texas State,Sun Belt,11,108,488,4.5,2,44.4,27,145,5.4,1,13.2,135,633,4.7,3,,caleb-twyford-1
209,Caleb Twyford,Texas State,Sun Belt,11,108,488,4.5,2,44.4,27,145,5.4,1,13.2,135,633,4.7,3,,caleb-twyford-2
210,Darius Bradwell*,Tulane,American,10,111,484,4.4,2,48.4,3,13,4.3,0,1.3,114,497,4.4,2,,darius-bradwell-1
211,Jabari Laws,Army,Ind,9,76,484,6.4,4,53.8,0,0,,0,0.0,76,484,6.4,4,,jabari-laws-1
212,Justin Fields*,Ohio State,Big Ten,14,137,484,3.5,10,34.6,0,0,,0,0.0,137,484,3.5,10,H-3,justin-fields-2
213,Malik Cunningham*,Louisville,ACC,12,123,482,3.9,6,40.2,0,0,,0,0.0,123,482,3.9,6,,malik-cunningham-1
214,Wayne Taulapapa*,Virginia,ACC,12,116,473,4.1,12,39.4,5,23,4.6,0,1.9,121,496,4.1,12,,wayne-taulapapa-1
215,Art Thompkins,Connecticut,American,12,98,468,4.8,2,39.0,39,257,6.6,2,21.4,137,725,5.3,4,,art-thompkins-1
216,Corey Taylor II,Tulsa,American,12,119,461,3.9,6,38.4,1,11,11.0,0,0.9,120,472,3.9,6,,corey-taylor-ii-1
217,Mataeo Durant,Duke,ACC,12,97,461,4.8,1,38.4,16,117,7.3,1,9.8,113,578,5.1,2,,mataeo-durant-1
218,Tyler Badie,Missouri,SEC,12,108,457,4.2,3,38.1,32,356,11.1,5,29.7,140,813,5.8,8,,tyler-badie-1
219,King Doerue,Purdue,Big Ten,12,130,451,3.5,5,37.6,20,148,7.4,2,12.3,150,599,4.0,7,,king-doerue-1
220,Demetrius Mauney,East Carolina,American,12,125,446,3.6,1,37.2,6,47,7.8,0,3.9,131,493,3.8,1,,demetrius-mauney-1
221,Jermaine Brown Jr.*,UAB,CUSA,10,86,446,5.2,2,44.6,4,21,5.3,0,2.1,90,467,5.2,2,,jermaine-brown-jr-1
222,Noah Cain*,Penn State,Big Ten,10,84,443,5.3,8,44.3,7,52,7.4,0,5.2,91,495,5.4,8,,noah-cain-1
223,Brian Robinson Jr.*,Alabama,SEC,13,96,441,4.6,5,33.9,11,124,11.3,0,9.5,107,565,5.3,5,,brian-robinson-jr-1
224,Jaren Mangham,Colorado,Pac-12,12,107,441,4.1,3,36.8,10,41,4.1,0,3.4,117,482,4.1,3,,jaren-mangham-1
225,Zac Thomas*,Appalachian State,Sun Belt,14,104,440,4.2,7,31.4,0,0,,0,0.0,104,440,4.2,7,,zac-thomas-2
226,Nick Gibson*,Mississippi State,SEC,11,55,433,7.9,6,39.4,4,34,8.5,0,3.1,59,467,7.9,6,,nick-gibson-1
227,Toren Young*,Iowa,Big Ten,12,81,432,5.3,1,36.0,1,7,7.0,0,0.6,82,439,5.4,1,,toren-young-1
228,Christian Anderson,Army,Ind,7,67,429,6.4,4,61.3,0,0,,0,0.0,67,429,6.4,4,,christian-anderson-2
229,Mike Glass III*,Eastern Michigan,MAC,12,118,428,3.6,8,35.7,0,0,,0,0.0,118,428,3.6,8,,mike-glass-iii-1
230,Tim Jordan*,Tennessee,SEC,12,104,428,4.1,1,35.7,6,46,7.7,0,3.8,110,474,4.3,1,,tim-jordan-2
231,Grant Loy,Bowling Green,MAC,12,100,427,4.3,4,35.6,0,0,,0,0.0,100,427,4.3,4,,grant-loy-1
232,Robert Mahone*,Boise State,MWC,12,89,425,4.8,6,35.4,9,76,8.4,0,6.3,98,501,5.1,6,,robert-mahone-1
233,Lucious Stanley*,UAB,CUSA,12,90,414,4.6,7,34.5,8,74,9.3,1,6.2,98,488,5.0,8,,lucious-stanley-1
234,James Charles*,Florida Atlantic,CUSA,13,78,413,5.3,5,31.8,6,46,7.7,0,3.5,84,459,5.5,5,,james-charles-1
235,Khalil Tate,Arizona,Pac-12,11,90,413,4.6,3,37.5,0,0,,0,0.0,90,413,4.6,3,,khalil-tate-1
236,Shannon Brooks*,Minnesota,Big Ten,9,73,408,5.6,2,45.3,0,0,,0,0.0,73,408,5.6,2,,shannon-brooks-1
237,Zamir White*,Georgia,SEC,13,78,408,5.2,3,31.4,2,20,10.0,0,1.5,80,428,5.4,3,,zamir-white-1
238,Seth Paige*,Georgia State,Sun Belt,7,61,405,6.6,4,57.9,0,0,,0,0.0,61,405,6.6,4,,seth-paige-1
239,Skylar Thompson*,Kansas State,Big 12,13,114,405,3.6,11,31.2,0,0,,0,0.0,114,405,3.6,11,,skylar-thompson-1
240,Sean Clifford*,Penn State,Big Ten,12,116,402,3.5,5,33.5,0,0,,0,0.0,116,402,3.5,5,,sean-clifford-1
241,D.J. Williams*,Auburn,SEC,8,84,400,4.8,2,50.0,5,32,6.4,0,4.0,89,432,4.9,2,,dj-williams-7
242,DJ Williams*,Auburn,SEC,9,84,400,4.8,2,44.4,5,32,6.4,0,3.6,89,432,4.9,2,,dj-williams-9
243,Kell Walker,Army,Ind,13,58,398,6.9,3,30.6,4,41,10.3,1,3.2,62,439,7.1,4,,kell-walker-1
244,Stephen Carr*,USC,Pac-12,10,72,396,5.5,5,39.6,22,143,6.5,1,14.3,94,539,5.7,6,,stephen-carr-2
245,Xavier Williams*,Kent State,MAC,11,86,393,4.6,4,35.7,5,105,21.0,2,9.5,91,498,5.5,6,,xavier-williams-2
246,Johnny Langan,Rutgers,Big Ten,11,134,391,2.9,3,35.5,0,0,,0,0.0,134,391,2.9,3,,johnny-langan-1
247,Bryce Carpenter,Coastal Carolina,Sun Belt,11,109,390,3.6,1,35.5,0,0,,0,0.0,109,390,3.6,1,,bryce-carpenter-1
248,Gary Brightwell,Arizona,Pac-12,11,66,390,5.9,5,35.5,4,59,14.8,1,5.4,70,449,6.4,6,,gary-brightwell-1
249,Sean Tyler*,Western Michigan,MAC,13,68,390,5.7,5,30.0,6,45,7.5,0,3.5,74,435,5.9,5,,sean-tyler-1
250,Trey Sermon*,Oklahoma,Big 12,9,54,385,7.1,4,42.8,8,71,8.9,1,7.9,62,456,7.4,5,,trey-sermon-1
251,Chance Bell*,San Diego State,MWC,12,89,384,4.3,2,32.0,12,77,6.4,0,6.4,101,461,4.6,2,,chance-bell-1
252,Khalil Herbert,Kansas,Big 12,4,43,384,8.9,2,96.0,1,-1,-1.0,0,-0.3,44,383,8.7,2,,khalil-herbert-1
253,Cole McDonald*,Hawaii,MWC,14,101,383,3.8,7,27.4,0,0,,0,0.0,101,383,3.8,7,,cole-mcdonald-1
254,Tommy Stevens*,Mississippi State,SEC,9,83,381,4.6,4,42.3,0,0,,0,0.0,83,381,4.6,4,,tommy-stevens-1
255,Aaron McAllister*,Charlotte,CUSA,11,81,380,4.7,5,34.5,7,69,9.9,2,6.3,88,449,5.1,7,,aaron-mcallister-1
256,Deandre Torrey,North Texas,CUSA,10,73,380,5.2,2,38.0,16,96,6.0,1,9.6,89,476,5.3,3,,deandre-torrey-1
257,Jordon Brown*,Kansas State,Big 12,11,84,380,4.5,4,34.5,14,138,9.9,0,12.5,98,518,5.3,4,,jordon-brown-1
258,Patrick Carr,Houston,American,6,67,380,5.7,4,63.3,7,38,5.4,0,6.3,74,418,5.6,4,,patrick-carr-1
259,Alexander Horvath,Purdue,Big Ten,11,79,377,4.8,2,34.3,17,142,8.4,1,12.9,96,519,5.4,3,,alexander-horvath-1
260,Jamal Jones*,Arkansas State,Sun Belt,10,84,375,4.5,3,37.5,6,30,5.0,0,3.0,90,405,4.5,3,,jamal-jones-4
261,Mulbah Car,Houston,American,4,59,375,6.4,3,93.8,1,-5,-5.0,0,-1.3,60,370,6.2,3,,mulbah-car-1
262,Sheldon Evans*,Marshall,CUSA,12,69,375,5.4,1,31.3,3,37,12.3,0,3.1,72,412,5.7,1,,sheldon-evans-1
263,Armand Shyne,Texas Tech,Big 12,8,65,374,5.8,3,46.8,13,67,5.2,0,8.4,78,441,5.7,3,,armand-shyne-1
264,Kenan Christon*,USC,Pac-12,7,68,373,5.5,2,53.3,11,126,11.5,3,18.0,79,499,6.3,5,,kenan-christon-1
265,Amare Jones*,Tulane,American,13,61,371,6.1,4,28.5,34,367,10.8,2,28.2,95,738,7.8,6,,amare-jones-1
266,Marcus McElroy,Colorado State,MWC,11,80,370,4.6,3,33.6,5,21,4.2,0,1.9,85,391,4.6,3,,marcus-mcelroy-1
267,Antonio Gibson*,Memphis,American,14,33,369,11.2,4,26.4,38,735,19.3,8,52.5,71,1104,15.5,12,,antonio-gibson-2
268,Chad Magyar,Nevada-Las Vegas,MWC,8,69,369,5.3,1,46.1,8,34,4.3,0,4.3,77,403,5.2,1,,chad-magyar-1
269,Joe Burrow*,LSU,SEC,15,115,368,3.2,5,24.5,1,16,16.0,0,1.1,116,384,3.3,5,H-1MaxwellAACamp,joe-burrow-1
270,Leddie Brown,West Virginia,Big 12,12,107,367,3.4,1,30.6,17,145,8.5,1,12.1,124,512,4.1,2,,leddie-brown-1
271,Chase Jasmin*,San Diego State,MWC,13,79,366,4.6,4,28.2,14,105,7.5,1,8.1,93,471,5.1,5,,chase-jasmin-1
272,Marcus Childers,Northern Illinois,MAC,9,59,366,6.2,5,40.7,0,0,,0,0.0,59,366,6.2,5,,marcus-childers-1
273,Cameron Carroll*,Tulane,American,11,72,364,5.1,4,33.1,2,0,0.0,1,0.0,74,364,4.9,5,,cameron-carroll-1
274,Kelley Joiner Jr.,South Florida,American,11,71,364,5.1,0,33.1,9,108,12.0,0,9.8,80,472,5.9,0,,kelley-joiner-jr-1
275,Brian Lewerke*,Michigan State,Big Ten,13,111,363,3.3,3,27.9,1,17,17.0,0,1.3,112,380,3.4,3,,brian-lewerke-1
276,Jacqez Hairston,Coastal Carolina,Sun Belt,12,79,360,4.6,6,30.0,0,0,,0,0.0,79,360,4.6,6,,jacqez-hairston-1
277,Holton Ahlers,East Carolina,American,12,108,359,3.3,6,29.9,0,0,,0,0.0,108,359,3.3,6,,holton-ahlers-1
278,Sione Finau*,BYU,Ind,8,59,359,6.1,2,44.9,4,29,7.3,0,3.6,63,388,6.2,2,,sione-finau-1
279,Lopini Katoa*,BYU,Ind,12,85,358,4.2,4,29.8,24,288,12.0,1,24.0,109,646,5.9,5,,lopini-katoa-1
280,Hendon Hooker*,Virginia Tech,ACC,11,123,356,2.9,5,32.4,0,-4,,0,-0.4,123,352,2.9,5,,hendon-hooker-1
281,Cam Roberson,Massachusetts,Ind,12,116,355,3.1,2,29.6,15,59,3.9,0,4.9,131,414,3.2,2,,cam-roberson-1
282,Jayden Daniels*,Arizona State,Pac-12,12,125,355,2.8,3,29.6,0,0,,0,0.0,125,355,2.8,3,,jayden-daniels-1
283,Jordan Byrd*,San Diego State,MWC,12,78,355,4.6,3,29.6,16,64,4.0,0,5.3,94,419,4.5,3,,jordan-byrd-1
284,Kesean Strong,Old Dominion,CUSA,11,84,353,4.2,4,32.1,27,200,7.4,0,18.2,111,553,5.0,4,,kesean-strong-1
285,Davon Tucker*,Western Michigan,MAC,13,69,351,5.1,2,27.0,2,11,5.5,0,0.8,71,362,5.1,2,,davon-tucker-1
286,Patrick Taylor Jr.*,Memphis,American,6,78,350,4.5,5,58.3,8,52,6.5,0,8.7,86,402,4.7,5,,patrick-taylor-jr-1
287,Charlie Brewer*,Baylor,Big 12,14,147,344,2.3,11,24.6,0,0,,0,0.0,147,344,2.3,11,,charlie-brewer-1
288,Jalen Cropper,Fresno State,MWC,10,20,343,17.2,3,34.3,15,196,13.1,0,19.6,35,539,15.4,3,,jalen-cropper-1
289,Sean McGrew*,Washington,Pac-12,12,55,342,6.2,1,28.5,10,38,3.8,0,3.2,65,380,5.8,1,,sean-mcgrew-1
290,Israel Tucker*,Louisiana Tech,CUSA,10,65,340,5.2,2,34.0,13,109,8.4,1,10.9,78,449,5.8,3,,israel-tucker-1
291,Keshawn King*,Virginia Tech,ACC,11,79,340,4.3,2,30.9,9,154,17.1,0,14.0,88,494,5.6,2,,keshawn-king-1
292,Ta'Zhawn Henry,Texas Tech,Big 12,9,75,340,4.5,3,37.8,22,138,6.3,0,15.3,97,478,4.9,3,,tazhawn-henry-1
293,Wan'Dale Robinson,Nebraska,Big Ten,10,88,340,3.9,3,34.0,40,453,11.3,2,45.3,128,793,6.2,5,,wandale-robinson-1
294,Cyrus Habibi-Likio*,Oregon,Pac-12,13,85,337,4.0,10,25.9,9,32,3.6,0,2.5,94,369,3.9,10,,cyrus-habibi-likio-1
295,Elijah Davis,Old Dominion,CUSA,11,79,337,4.3,4,30.6,4,1,0.3,0,0.1,83,338,4.1,4,,elijah-davis-3
296,Jarveon Howard,Syracuse,ACC,11,76,337,4.4,3,30.6,9,53,5.9,0,4.8,85,390,4.6,3,,jarveon-howard-1
297,Lala Davis,Old Dominion,CUSA,11,79,337,4.3,4,30.6,4,1,0.3,0,0.1,83,338,4.1,4,,lala-davis-1
298,Titus Swen*,Wyoming,MWC,8,67,337,5.0,1,42.1,3,46,15.3,0,5.8,70,383,5.5,1,,titus-swen-1
299,Abdul Adams,Syracuse,ACC,11,87,336,3.9,3,30.5,15,141,9.4,0,12.8,102,477,4.7,3,,abdul-adams-1
300,Chris Smith*,Louisiana,Sun Belt,14,32,334,10.4,4,23.9,1,10,10.0,0,0.7,33,344,10.4,4,,chris-smith-22
301,Kam Martin*,Auburn,SEC,12,61,333,5.5,2,27.8,3,21,7.0,0,1.8,64,354,5.5,2,,kam-martin-1
302,Matt Laroche*,Georgia Southern,Sun Belt,12,62,333,5.4,1,27.8,2,-6,-3.0,0,-0.5,64,327,5.1,1,,matt-laroche-1
303,Mitchell Guadagni,Toledo,MAC,6,63,332,5.3,4,55.3,1,5,5.0,0,0.8,64,337,5.3,4,,mitchell-guadagni-1
304,Demetric Felton,UCLA,Pac-12,12,86,331,3.8,1,27.6,55,594,10.8,4,49.5,141,925,6.6,5,,demetric-felton-1
305,Nakia Watson*,Wisconsin,Big Ten,14,74,331,4.5,2,23.6,3,3,1.0,0,0.2,77,334,4.3,2,,nakia-watson-1
306,Kylan Watkins*,Memphis,American,11,62,325,5.2,3,29.5,5,40,8.0,1,3.6,67,365,5.4,4,,kylan-watkins-1
307,Larry McCammon III*,Florida Atlantic,CUSA,9,91,324,3.6,7,36.0,13,88,6.8,0,9.8,104,412,4.0,7,,larry-mccammon-iii-1
308,Kaylan Wiggins*,Florida International,CUSA,10,49,323,6.6,3,32.3,0,0,,0,0.0,49,323,6.6,3,,kaylan-wiggins-1
309,Kennedy McKoy,West Virginia,Big 12,12,99,323,3.3,3,26.9,37,167,4.5,1,13.9,136,490,3.6,4,,kennedy-mckoy-1
310,Antonio Williams*,North Carolina,ACC,12,48,322,6.7,3,26.8,2,4,2.0,0,0.3,50,326,6.5,3,,antonio-williams-1
311,Jo-El Shaw*,Kent State,MAC,8,73,320,4.4,2,40.0,6,46,7.7,0,5.8,79,366,4.6,2,,jo-el-shaw-1
312,Daetrich Harrington*,Appalachian State,Sun Belt,8,50,319,6.4,2,39.9,1,6,6.0,0,0.8,51,325,6.4,2,,daetrich-harrington-1
313,Jon Wassink*,Western Michigan,MAC,13,69,319,4.6,3,24.5,0,0,,0,0.0,69,319,4.6,3,,jon-wassink-1
314,Vincent Davis*,Pitt,ACC,11,61,314,5.1,5,28.5,5,28,5.6,0,2.5,66,342,5.2,5,,vincent-davis-3
315,Bo Nix*,Auburn,SEC,13,97,313,3.2,7,24.1,0,0,,0,0.0,97,313,3.2,7,,bo-nix-1
316,D'Eriq King,Houston,American,4,55,312,5.7,6,78.0,0,0,,0,0.0,55,312,5.7,6,,deriq-king-1
317,Joshua Fields,UTEP,CUSA,12,59,312,5.3,0,26.0,5,7,1.4,0,0.6,64,319,5.0,0,,joshua-fields-1
318,Markese Stepp*,USC,Pac-12,6,48,307,6.4,3,51.2,0,0,,0,0.0,48,307,6.4,3,,markese-stepp-1
319,Dameon Pierce*,Florida,SEC,12,54,305,5.6,4,25.4,4,30,7.5,0,2.5,58,335,5.8,4,,dameon-pierce-1
320,Christian Beal*,Wake Forest,ACC,8,71,304,4.3,2,38.0,6,25,4.2,0,3.1,77,329,4.3,2,,christian-beal-1
321,Christian Beal-Smith*,Wake Forest,ACC,9,71,304,4.3,2,33.8,6,25,4.2,0,2.8,77,329,4.3,2,,christian-beal-smith-1
322,Devonte Lee*,Nevada,MWC,9,66,302,4.6,7,33.6,5,35,7.0,0,3.9,71,337,4.7,7,,devonte-lee-1
323,Isaiah Green*,Marshall,CUSA,13,114,300,2.6,5,23.1,0,0,,0,0.0,114,300,2.6,5,,isaiah-green-2
324,Ishod Finger*,Charlotte,CUSA,12,60,299,5.0,5,24.9,6,41,6.8,0,3.4,66,340,5.2,5,,ishod-finger-1
325,CJ Williams*,Navy,American,13,56,298,5.3,3,22.9,7,210,30.0,2,16.2,63,508,8.1,5,,cj-williams-2
326,Maurice Washington,Nebraska,Big Ten,7,50,298,6.0,1,42.6,12,162,13.5,2,23.1,62,460,7.4,3,,maurice-washington-2
327,Khalan Laborn*,Florida State,ACC,10,63,297,4.7,4,29.7,10,66,6.6,0,6.6,73,363,5.0,4,,khalan-laborn-1
328,Khalan Laborn*,Florida State,ACC,10,63,297,4.7,4,29.7,10,66,6.6,0,6.6,73,363,5.0,4,,khalan-laborn-2
329,Tyrion Davis-Price*,LSU,SEC,14,64,295,4.6,6,21.1,10,74,7.4,0,5.3,74,369,5.0,6,,tyrion-davis-price-1
330,Devyn Ford*,Penn State,Big Ten,12,52,294,5.7,3,24.5,5,30,6.0,0,2.5,57,324,5.7,3,,devyn-ford-1
331,Logan Wright*,Georgia Southern,Sun Belt,5,52,294,5.7,2,58.8,2,7,3.5,0,1.4,54,301,5.6,2,,logan-wright-2
332,Freddie Holly*,Hawaii,MWC,12,52,292,5.6,2,24.3,2,7,3.5,0,0.6,54,299,5.5,2,,freddie-holly-1
333,Joachim Bangda*,Kent State,MAC,10,45,291,6.5,1,29.1,4,13,3.3,0,1.3,49,304,6.2,1,,joachim-bangda-1
334,James Graham,Georgia Tech,ACC,11,99,290,2.9,3,26.4,0,0,,0,0.0,99,290,2.9,3,,james-graham-1
335,Terell West,Middle Tennessee State,CUSA,10,39,290,7.4,4,29.0,6,26,4.3,0,2.6,45,316,7.0,4,,terell-west-1
336,Tyler Huntley*,Utah,Pac-12,14,104,290,2.8,5,20.7,0,0,,0,0.0,104,290,2.8,5,,tyler-huntley-1
337,Darius Pinnix,East Carolina,American,4,73,289,4.0,4,72.3,6,38,6.3,0,9.5,79,327,4.1,4,,darius-pinnix-1
338,Josh Hokit,Fresno State,MWC,12,75,287,3.8,9,23.9,17,97,5.7,1,8.1,92,384,4.2,10,,josh-hokit-1
339,Trevon Woolfolk,Troy,Sun Belt,10,71,287,4.0,3,28.7,12,42,3.5,2,4.2,83,329,4.0,5,,trevon-woolfolk-1
340,Evan Hull,Northwestern,Big Ten,5,46,286,6.2,4,57.2,0,0,,0,0.0,46,286,6.2,4,,evan-hull-2
341,Shaun Shivers*,Auburn,SEC,12,55,286,5.2,3,23.8,4,1,0.3,0,0.1,59,287,4.9,3,,shaun-shivers-1
342,Brenden Brady,UTSA,CUSA,12,67,284,4.2,2,23.7,14,115,8.2,0,9.6,81,399,4.9,2,,brenden-brady-1
343,Julian Ross*,Ohio,MAC,9,76,284,3.7,1,31.6,4,40,10.0,1,4.4,80,324,4.1,2,,julian-ross-1
344,Jordan McCloud,South Florida,American,12,105,283,2.7,4,23.6,0,0,,0,0.0,105,283,2.7,4,,jordan-mccloud-1
345,Tobias Oliver,Georgia Tech,ACC,12,55,279,5.1,2,23.3,11,106,9.6,1,8.8,66,385,5.8,3,,tobias-oliver-1
346,Devwah Whaley,Arkansas,SEC,12,69,278,4.0,4,23.2,16,141,8.8,0,11.8,85,419,4.9,4,,devwah-whaley-1
347,Chez Mellusi*,Clemson,ACC,12,44,276,6.3,3,23.0,0,0,,0,0.0,44,276,6.3,3,,chez-mellusi-1
348,Ty Storey*,Western Kentucky,CUSA,11,118,276,2.3,7,25.1,2,14,7.0,1,1.3,120,290,2.4,8,,ty-storey-1
349,Sampson James*,Indiana,Big Ten,13,81,275,3.4,3,21.2,2,21,10.5,0,1.6,83,296,3.6,3,,sampson-james-1
350,Jackson McChesney*,BYU,Ind,3,25,274,11.0,2,91.3,2,-7,-3.5,0,-2.3,27,267,9.9,2,,jackson-mcchesney-1
351,Jordan Nettles,Northern Illinois,MAC,12,67,274,4.1,0,22.8,4,8,2.0,0,0.7,71,282,4.0,0,,jordan-nettles-1
352,Keyon Brooks,Vanderbilt,SEC,11,56,273,4.9,1,24.8,16,57,3.6,0,5.2,72,330,4.6,1,,keyon-brooks-1
353,Charlie Booker,Rice,CUSA,10,88,272,3.1,1,27.2,0,0,,0,0.0,88,272,3.1,1,,charlie-booker-1
354,Gerry Bohanon*,Baylor,Big 12,10,42,272,6.5,3,27.2,0,0,,0,0.0,42,272,6.5,3,,gerry-bohanon-1
355,Trace Christian,East Carolina,American,7,64,269,4.2,0,38.4,4,25,6.3,0,3.6,68,294,4.3,0,,trace-christian-1
356,Tazh Maloy*,Navy,American,10,32,267,8.3,1,26.7,2,51,25.5,0,5.1,34,318,9.4,1,,tazh-maloy-1
357,Andrew Van Buren*,Boise State,MWC,14,62,265,4.3,2,18.9,8,47,5.9,1,3.4,70,312,4.5,3,,andrew-van-buren-1
358,Tayon Fleet-Davis,Maryland,Big Ten,10,63,265,4.2,2,26.5,15,181,12.1,2,18.1,78,446,5.7,4,,tayon-fleet-davis-1
359,J'mar Smith*,Louisiana Tech,CUSA,11,100,264,2.6,4,24.0,0,0,,0,0.0,100,264,2.6,4,,jmar-smith-1
360,Jorge Reyna,Fresno State,MWC,12,98,264,2.7,2,22.0,0,6,,0,0.5,98,270,2.8,2,,jorge-reyna-1
361,Ty'Son Williams*,BYU,Ind,4,49,264,5.4,3,66.0,7,47,6.7,0,11.8,56,311,5.6,3,,tyson-williams-4
362,Devin Brumfield*,Utah,Pac-12,14,59,263,4.5,2,18.8,9,41,4.6,0,2.9,68,304,4.5,2,,devin-brumfield-1
363,Harry Trotter*,Kansas State,Big 12,13,66,263,4.0,3,20.2,3,16,5.3,0,1.2,69,279,4.0,3,,harry-trotter-1
364,Tevaka Tuioti,New Mexico,MWC,9,52,262,5.0,0,29.1,0,0,,0,0.0,52,262,5.0,0,,tevaka-tuioti-1
365,Carlos Davis,South Alabama,Sun Belt,11,60,261,4.4,2,23.7,6,43,7.2,0,3.9,66,304,4.6,2,,carlos-davis-4
366,Emory Jones*,Florida,SEC,11,42,256,6.1,4,23.3,0,0,,0,0.0,42,256,6.1,4,,emory-jones-1
367,Nick Nash,San Jose State,MWC,6,40,255,6.4,3,42.5,1,4,4.0,0,0.7,41,259,6.3,3,,nick-nash-1
368,Keilan Robinson*,Alabama,SEC,8,39,254,6.5,2,31.8,0,0,,0,0.0,39,254,6.5,2,,keilan-robinson-1
369,Peyton Ramsey*,Indiana,Big Ten,11,97,252,2.6,7,22.9,0,0,,0,0.0,97,252,2.6,7,,peyton-ramsey-1
370,Stephon Huderson*,Tulane,American,12,43,251,5.8,1,20.9,3,70,23.3,1,5.8,46,321,7.0,2,,stephon-huderson-1
371,Trestan Ebner*,Baylor,Big 12,14,53,250,4.7,3,17.9,24,317,13.2,2,22.6,77,567,7.4,5,,trestan-ebner-1
372,Brock Purdy*,Iowa State,Big 12,13,93,249,2.7,8,19.2,0,0,,0,0.0,93,249,2.7,8,,brock-purdy-1
373,D'Vonte Price*,Florida International,CUSA,12,50,249,5.0,0,20.8,10,49,4.9,0,4.1,60,298,5.0,0,,dvonte-price-1
374,Todd Sibley Jr.*,Pitt,ACC,9,50,249,5.0,0,27.7,2,18,9.0,0,2.0,52,267,5.1,0,,todd-sibley-jr-1
375,Marcel Dancy*,California,Pac-12,12,57,248,4.4,2,20.7,20,153,7.7,0,12.8,77,401,5.2,2,,marcel-dancy-1
376,Tyler Johnston III*,UAB,CUSA,11,84,247,2.9,1,22.5,0,0,,0,0.0,84,247,2.9,1,,tyler-johnston-iii-1
377,Andrew Clair,Bowling Green,MAC,4,68,244,3.6,4,61.0,10,71,7.1,0,17.8,78,315,4.0,4,,andrew-clair-1
378,Clayton Tune,Houston,American,7,66,244,3.7,2,34.9,0,0,,0,0.0,66,244,3.7,2,,clayton-tune-1
379,Loren Easly,North Texas,CUSA,8,55,243,4.4,1,30.4,2,26,13.0,0,3.3,57,269,4.7,1,,loren-easly-1
380,V'Lique Carter*,Pitt,ACC,13,65,243,3.7,0,18.7,17,183,10.8,2,14.1,82,426,5.2,2,,vlique-carter-1
381,Kelly Bryant,Missouri,SEC,10,106,242,2.3,1,24.2,0,0,,0,0.0,106,242,2.3,1,,kelly-bryant-1
382,Quincy Patterson*,Virginia Tech,ACC,7,50,241,4.8,2,34.4,0,0,,0,0.0,50,241,4.8,2,,quincy-patterson-1
383,Nick Tronti*,Florida Atlantic,CUSA,11,51,239,4.7,2,21.7,1,41,41.0,0,3.7,52,280,5.4,2,,nick-tronti-1
384,Johnnie Lang*,Iowa State,Big 12,12,50,238,4.8,3,19.8,8,54,6.8,1,4.5,58,292,5.0,4,,johnnie-lang-1
385,B.J. Emmons*,Florida Atlantic,CUSA,5,51,237,4.6,6,47.4,3,11,3.7,0,2.2,54,248,4.6,6,,bj-emmons-1
386,Marcus Crowley*,Ohio State,Big Ten,7,25,237,9.5,1,33.9,1,7,7.0,1,1.0,26,244,9.4,2,,marcus-crowley-1
387,TJ McDaniel*,SMU,American,11,41,236,5.8,3,21.5,3,31,10.3,0,2.8,44,267,6.1,3,,tj-mcdaniel-1
388,Ronnie Jones,Toledo,MAC,12,34,233,6.9,4,19.4,5,44,8.8,0,3.7,39,277,7.1,4,,ronnie-jones-2
389,Cordarrian Richardson*,Texas A&M,SEC,11,25,232,9.3,4,21.1,1,17,17.0,1,1.5,26,249,9.6,5,,cordarrian-richardson-1
390,Mon Denson,South Carolina,SEC,9,39,232,5.9,3,25.8,0,0,,0,0.0,39,232,5.9,3,,mon-denson-1
391,Tre Turner*,Virginia Tech,ACC,11,24,231,9.6,1,21.0,34,553,16.3,4,50.3,58,784,13.5,5,,tre-turner-2
392,Ricky Person Jr.,North Carolina State,ACC,7,61,229,3.8,3,32.7,8,99,12.4,1,14.1,69,328,4.8,4,,ricky-person-jr-1
393,Jordan Travis*,Florida State,ACC,4,23,228,9.9,3,57.0,1,18,18.0,0,4.5,24,246,10.3,3,,jordan-travis-1
394,Nathan Tilford,Arizona,Pac-12,10,37,228,6.2,4,22.8,1,4,4.0,0,0.4,38,232,6.1,4,,nathan-tilford-1
395,Austin Jones,Stanford,Pac-12,12,45,227,5.0,1,18.9,14,108,7.7,0,9.0,59,335,5.7,1,,austin-jones-6
396,Dawson Downing,Missouri,SEC,12,40,227,5.7,1,18.9,8,27,3.4,0,2.3,48,254,5.3,1,,dawson-downing-1
397,Trey Smith*,Wyoming,MWC,4,44,227,5.2,3,56.8,0,0,,0,0.0,44,227,5.2,3,,trey-smith-4
398,Ra'Von Bonner*,Illinois,Big Ten,12,65,225,3.5,3,18.8,4,67,16.8,1,5.6,69,292,4.2,4,,ravon-bonner-1
399,Anthony Taylor,Texas State,Sun Belt,11,74,223,3.0,2,20.3,20,110,5.5,1,10.0,94,333,3.5,3,,anthony-taylor-7
400,Chase Garbers*,California,Pac-12,9,90,223,2.5,3,24.8,0,0,,0,0.0,90,223,2.5,3,,chase-garbers-1
401,Raykwon Anderson*,Appalachian State,Sun Belt,9,33,223,6.8,2,24.8,2,0,0.0,0,0.0,35,223,6.4,2,,raykwon-anderson-1
402,Jaylen Thomas,Colorado State,MWC,10,68,222,3.3,3,22.2,14,113,8.1,0,11.3,82,335,4.1,3,,jaylen-thomas-1
403,LD Brown*,Oklahoma State,Big 12,13,40,221,5.5,2,17.0,3,32,10.7,0,2.5,43,253,5.9,2,,ld-brown-2
404,Tru Wilson*,Michigan,Big Ten,10,44,221,5.0,1,22.1,2,14,7.0,0,1.4,46,235,5.1,1,,tru-wilson-1
405,T.K. Wilkerson,Tulsa,American,12,52,220,4.2,6,18.3,1,12,12.0,1,1.0,53,232,4.4,7,,tk-wilkerson-1
406,Dylan Hopkins*,UAB,CUSA,10,64,217,3.4,1,21.7,0,0,,0,0.0,64,217,3.4,1,,dylan-hopkins-1
407,Dante Wright,Colorado State,MWC,12,17,214,12.6,2,17.8,57,805,14.1,4,67.1,74,1019,13.8,6,,dante-wright-1
408,Ricky Slade*,Penn State,Big Ten,12,47,214,4.6,2,17.8,12,105,8.8,0,8.8,59,319,5.4,2,,ricky-slade-1
409,Brandon Peters*,Illinois,Big Ten,11,74,213,2.9,3,19.4,0,0,,0,0.0,74,213,2.9,3,,brandon-peters-1
410,Will Levis*,Penn State,Big Ten,7,51,213,4.2,3,30.4,0,0,,0,0.0,51,213,4.2,3,,will-levis-1
411,Chevan Cordeiro*,Hawaii,MWC,12,40,212,5.3,3,17.7,0,0,,0,0.0,40,212,5.3,3,,chevan-cordeiro-1
412,Jett Duffey,Texas Tech,Big 12,10,72,212,2.9,1,21.2,1,14,14.0,0,1.4,73,226,3.1,1,,jett-duffey-1
413,Keoni-Kordell Mahekau*,Navy,American,11,30,212,7.1,0,19.3,5,175,35.0,1,15.9,35,387,11.1,1,,keoni-kordell-mahekau-1
414,Keoni-Kordell Makekau*,Navy,American,13,30,212,7.1,0,16.3,5,175,35.0,1,13.5,35,387,11.1,1,,keoni-kordell-makekau-1
415,Aiden Smith,Northwestern,Big Ten,9,72,211,2.9,1,23.4,0,0,,0,0.0,72,211,2.9,1,,aiden-smith-1
416,Dennis Grosel*,Boston College,ACC,13,57,209,3.7,2,16.1,0,0,,0,0.0,57,209,3.7,2,,dennis-grosel-1
417,Chaton Mobley,Middle Tennessee State,CUSA,8,52,208,4.0,3,26.0,8,126,15.8,0,15.8,60,334,5.6,3,,chaton-mobley-1
418,Jaquis Dancy*,Louisiana Tech,CUSA,6,44,207,4.7,2,34.5,9,65,7.2,0,10.8,53,272,5.1,2,,jaquis-dancy-1
419,Joshua Stoner*,Air Force,MWC,8,23,207,9.0,1,25.9,0,0,,0,0.0,23,207,9.0,1,,joshua-stoner-1
420,Trevon Sands,South Florida,American,8,49,207,4.2,2,25.9,5,28,5.6,0,3.5,54,235,4.4,2,,trevon-sands-1
421,DeAndre Marcus*,Louisiana Tech,CUSA,11,26,205,7.9,1,18.6,2,12,6.0,0,1.1,28,217,7.8,1,,deandre-marcus-1
422,Armani Rogers,Nevada-Las Vegas,MWC,5,50,204,4.1,2,40.8,0,0,,0,0.0,50,204,4.1,2,,armani-rogers-1
423,Isaiah Bowser,Northwestern,Big Ten,5,59,204,3.5,0,40.8,7,24,3.4,0,4.8,66,228,3.5,0,,isaiah-bowser-1
424,Javy McDonald,Middle Tennessee State,CUSA,12,40,204,5.1,1,17.0,2,13,6.5,0,1.1,42,217,5.2,1,,javy-mcdonald-1
425,Maurice Thomas*,Miami (OH),MAC,14,41,204,5.0,0,14.6,10,22,2.2,0,1.6,51,226,4.4,0,,maurice-thomas-2
426,Sheriron Jones,New Mexico,MWC,6,47,204,4.3,3,34.0,0,0,,0,0.0,47,204,4.3,3,,sheriron-jones-1
427,Bam Smith,Arizona,Pac-12,9,34,203,6.0,1,22.6,12,181,15.1,2,20.1,46,384,8.3,3,,bam-smith-1
428,Andrew Marty,Northwestern,Big Ten,5,52,201,3.9,4,40.2,0,0,,0,0.0,52,201,3.9,4,,andrew-marty-1
429,Braden Lenzy*,Notre Dame,Ind,9,13,200,15.4,2,22.2,11,254,23.1,2,28.2,24,454,18.9,4,,braden-lenzy-1
430,Austin Vaughn,Louisiana-Monroe,Sun Belt,11,50,199,4.0,5,18.1,5,23,4.6,0,2.1,55,222,4.0,5,,austin-vaughn-1
431,DeShawn Collins*,California,Pac-12,9,38,199,5.2,2,22.1,2,11,5.5,0,1.2,40,210,5.3,2,,deshawn-collins-1
432,Dorian Thompson-Robinson,UCLA,Pac-12,11,118,198,1.7,4,18.0,0,0,,0,0.0,118,198,1.7,4,,dorian-thompson-robinson-1
433,Darrian Felix*,Oregon,Pac-12,7,34,197,5.8,2,28.1,6,78,13.0,0,11.1,40,275,6.9,2,,darrian-felix-1
434,Desmond Trotter,South Alabama,Sun Belt,8,61,197,3.2,0,24.6,0,0,,0,0.0,61,197,3.2,0,,desmond-trotter-1
435,Justin Tomlin*,Georgia Southern,Sun Belt,7,30,196,6.5,2,28.0,0,0,,0,0.0,30,196,6.5,2,,justin-tomlin-1
436,Levi Lewis*,Louisiana,Sun Belt,14,69,195,2.8,3,13.9,0,0,,0,0.0,69,195,2.8,3,,levi-lewis-1
437,Steven Anderson*,Southern Mississippi,CUSA,12,62,195,3.1,3,16.3,2,8,4.0,0,0.7,64,203,3.2,3,,steven-anderson-1
438,Zay Flowers*,Boston College,ACC,13,27,195,7.2,1,15.0,22,341,15.5,3,26.2,49,536,10.9,4,,zay-flowers-1
439,Garrett Groshek*,Wisconsin,Big Ten,14,42,194,4.6,2,13.9,29,289,10.0,0,20.6,71,483,6.8,2,,garrett-groshek-1
440,Jordan Wilmore*,Utah,Pac-12,12,49,194,4.0,1,16.2,2,13,6.5,0,1.1,51,207,4.1,1,,jordan-wilmore-1
441,Christian Mallard*,Air Force,MWC,12,40,192,4.8,2,16.0,0,0,,0,0.0,40,192,4.8,2,,christian-mallard-1
442,Tyjae Spears*,Tulane,American,5,32,192,6.0,1,38.4,5,133,26.6,1,26.6,37,325,8.8,2,,tyjae-spears-1
443,Emmanuel Esukpa*,BYU,Ind,8,46,190,4.1,2,23.8,2,12,6.0,0,1.5,48,202,4.2,2,,emmanuel-esukpa-1
444,Tavion Thomas*,Cincinnati,American,4,40,190,4.8,1,47.5,1,6,6.0,0,1.5,41,196,4.8,1,,tavion-thomas-1
445,Bobby Cole,New Mexico,MWC,12,27,189,7.0,2,15.8,0,0,,0,0.0,27,189,7.0,2,,bobby-cole-3
446,Chris Curry*,LSU,SEC,14,38,189,5.0,0,13.5,3,23,7.7,0,1.6,41,212,5.2,0,,chris-curry-2
447,Devonta'e Henry-Cole*,Utah,Pac-12,12,34,188,5.5,2,15.7,3,23,7.7,1,1.9,37,211,5.7,3,,devontae-henry-cole-1
448,James Cook*,Georgia,SEC,14,31,188,6.1,2,13.4,16,132,8.3,0,9.4,47,320,6.8,2,,james-cook-2
449,John Emery Jr.*,LSU,SEC,10,39,188,4.8,4,18.8,6,60,10.0,0,6.0,45,248,5.5,4,,john-emery-jr-1
450,Justin Hall,Ball State,MAC,12,24,187,7.8,2,15.6,61,684,11.2,6,57.0,85,871,10.2,8,,justin-hall-3
451,Chauncey Mason*,Florida Atlantic,CUSA,12,32,186,5.8,0,15.5,6,78,13.0,1,6.5,38,264,6.9,1,,chauncey-mason-1
452,Malik Dunner,Ball State,MAC,12,11,184,16.7,2,15.3,6,39,6.5,1,3.3,17,223,13.1,3,,malik-dunner-1
453,Cephus Johnson,South Alabama,Sun Belt,8,75,181,2.4,4,22.6,0,0,,0,0.0,75,181,2.4,4,,cephus-johnson-2
454,Fred Payton,Coastal Carolina,Sun Belt,10,54,181,3.4,2,18.1,0,0,,0,0.0,54,181,3.4,2,,fred-payton-1
455,Isaiah Azubuike*,Arkansas State,Sun Belt,5,41,181,4.4,0,36.2,1,-4,-4.0,0,-0.8,42,177,4.2,0,,isaiah-azubuike-1
456,Levi Williams*,Wyoming,MWC,3,40,181,4.5,2,60.3,0,0,,0,0.0,40,181,4.5,2,,levi-williams-1
457,Stone Smartt,Old Dominion,CUSA,10,104,181,1.7,5,18.1,0,0,,0,0.0,104,181,1.7,5,,stone-smartt-1
458,Xavier Gaines*,Marshall,CUSA,13,26,181,7.0,2,13.9,27,306,11.3,3,23.5,53,487,9.2,5,,xavier-gaines-2
459,Jahmir Smith*,Notre Dame,Ind,10,42,180,4.3,2,18.0,2,12,6.0,0,1.2,44,192,4.4,2,,jahmir-smith-1
460,Kendric Pryor*,Wisconsin,Big Ten,14,13,180,13.8,2,12.9,23,278,12.1,0,19.9,36,458,12.7,2,,kendric-pryor-1
461,Brandon Lee,Akron,MAC,12,61,179,2.9,0,14.9,15,114,7.6,0,9.5,76,293,3.9,0,,brandon-lee-2
462,D.J. Mack Jr.*,UCF,American,9,41,179,4.4,3,19.9,0,0,,0,0.0,41,179,4.4,3,,dj-mack-jr-1
463,Kevin Harris,South Carolina,SEC,6,21,179,8.5,4,29.8,3,26,8.7,0,4.3,24,205,8.5,4,,kevin-harris-5
464,B.J. Baylor,Oregon State,Pac-12,12,30,177,5.9,3,14.8,1,6,6.0,0,0.5,31,183,5.9,3,,bj-baylor-1
465,Kyric McGowan,Northwestern,Big Ten,9,28,177,6.3,1,19.7,13,102,7.8,0,11.3,41,279,6.8,1,,kyric-mcgowan-1
466,Jared Wilson,South Alabama,Sun Belt,12,49,176,3.6,1,14.7,1,7,7.0,0,0.6,50,183,3.7,1,,jared-wilson-1
467,Jordan Love*,Utah State,MWC,13,81,175,2.2,0,13.5,0,0,,0,0.0,81,175,2.2,0,,jordan-love-2
468,Jonathan Haden*,UAB,CUSA,13,47,174,3.7,0,13.4,3,37,12.3,0,2.8,50,211,4.2,0,,jonathan-haden-1
469,Kairee Robinson,San Jose State,MWC,10,40,174,4.4,0,17.4,7,51,7.3,2,5.1,47,225,4.8,2,,kairee-robinson-1
470,Kenny McIntosh*,Georgia,SEC,11,25,174,7.0,2,15.8,1,3,3.0,0,0.3,26,177,6.8,2,,kenny-mcintosh-1
471,PK Kier*,Virginia,ACC,13,32,174,5.4,1,13.4,0,0,,0,0.0,32,174,5.4,1,,pk-kier-1
472,Jake Funk,Maryland,Big Ten,3,17,173,10.2,2,57.7,4,16,4.0,0,5.3,21,189,9.0,2,,jake-funk-1
473,Brett Brenton*,Wyoming,MWC,10,29,172,5.9,0,17.2,2,16,8.0,0,1.6,31,188,6.1,0,,brett-brenton-1
474,Davion Johnson*,Miami (OH),MAC,13,60,172,2.9,2,13.2,13,128,9.8,0,9.8,73,300,4.1,2,,davion-johnson-2
475,Christian Turner*,Michigan,Big Ten,10,44,171,3.9,1,17.1,4,13,3.3,0,1.3,48,184,3.8,1,,christian-turner-1
476,Drew Plitt,Ball State,MAC,12,91,171,1.9,5,14.3,1,2,2.0,0,0.2,92,173,1.9,5,,drew-plitt-1
477,Brad Anderson,Middle Tennessee State,CUSA,11,37,170,4.6,0,15.5,14,39,2.8,0,3.5,51,209,4.1,0,,brad-anderson-3
478,Devon Modster*,California,Pac-12,6,48,168,3.5,1,28.0,0,0,,0,0.0,48,168,3.5,1,,devon-modster-1
479,Ja'Vhari Portis*,Ohio,MAC,7,28,168,6.0,4,24.0,0,0,,0,0.0,28,168,6.0,4,,javhari-portis-1
480,Trillion Coles*,UCF,American,7,33,168,5.1,0,24.0,0,0,,0,0.0,33,168,5.1,0,,trillion-coles-1
481,Reese White,Coastal Carolina,Sun Belt,10,36,167,4.6,3,16.7,4,90,22.5,2,9.0,40,257,6.4,5,,reese-white-1
482,Zach Wilson*,BYU,Ind,9,67,167,2.5,3,18.6,1,19,19.0,0,2.1,68,186,2.7,3,,zach-wilson-3
483,Luke McCaffrey,Nebraska,Big Ten,4,24,166,6.9,1,41.5,1,12,12.0,0,3.0,25,178,7.1,1,,luke-mccaffrey-1
484,Tay Williams,East Carolina,American,9,34,164,4.8,0,18.2,5,12,2.4,0,1.3,39,176,4.5,0,,tay-williams-1
485,Trae Hall,New Mexico,MWC,4,28,163,5.8,2,40.8,0,0,,0,0.0,28,163,5.8,2,,trae-hall-1
486,C'Bo Flemister*,Notre Dame,Ind,10,48,162,3.4,5,16.2,1,13,13.0,0,1.3,49,175,3.6,5,,cbo-flemister-1
487,Kay'ron Adams,Rutgers,Big Ten,9,48,161,3.4,1,17.9,2,47,23.5,0,5.2,50,208,4.2,1,,kayron-adams-1
488,Laviska Shenault Jr.,Colorado,Pac-12,11,23,161,7.0,2,14.6,56,764,13.6,4,69.5,79,925,11.7,6,,laviska-shenault-jr-1
489,Robert Brown,Texas State,Sun Belt,7,28,161,5.8,1,23.0,3,11,3.7,0,1.6,31,172,5.5,1,,robert-brown-1
490,Tommy Lazzaro*,Central Michigan,MAC,13,36,161,4.5,8,12.4,0,0,,0,0.0,36,161,4.5,8,,tommy-lazzaro-1
491,Chandler Smith,Houston,American,9,32,159,5.0,0,17.7,5,8,1.6,0,0.9,37,167,4.5,0,,chandler-smith-1
492,Jovoni Johnson,Rice,CUSA,4,27,159,5.9,2,39.8,0,0,,0,0.0,27,159,5.9,2,,jovoni-johnson-1
493,Artice Hobbs IV,Army,Ind,13,28,158,5.6,2,12.2,13,335,25.8,1,25.8,41,493,12.0,3,,artice-hobbs-iv-1
494,Jairus Grissom*,Eastern Michigan,MAC,13,20,156,7.8,1,12.0,4,32,8.0,1,2.5,24,188,7.8,2,,jairus-grissom-1
495,Jaylon Henderson*,Boise State,MWC,9,46,156,3.4,2,17.3,0,0,,0,0.0,46,156,3.4,2,,jaylon-henderson-2
496,Todd Centeio*,Temple,American,10,47,155,3.3,0,15.5,1,7,7.0,0,0.7,48,162,3.4,0,,todd-centeio-1
497,John Hightower*,Boise State,MWC,14,16,154,9.6,0,11.0,51,943,18.5,8,67.4,67,1097,16.4,8,,john-hightower-1
498,Aaron Young,Rutgers,Big Ten,12,43,153,3.6,0,12.8,15,113,7.5,0,9.4,58,266,4.6,0,,aaron-young-5
499,Steven Montez,Colorado,Pac-12,12,65,153,2.4,3,12.8,0,0,,0,0.0,65,153,2.4,3,,steven-montez-1
500,Tyrrell Pigrome,Maryland,Big Ten,11,45,153,3.4,2,13.9,0,0,,0,0.0,45,153,3.4,2,,tyrrell-pigrome-1
501,Dylan McDuffie*,Buffalo,MAC,10,23,150,6.5,0,15.0,3,25,8.3,1,2.5,26,175,6.7,1,,dylan-mcduffie-1
502,Michel Dukes*,Clemson,ACC,10,32,150,4.7,2,15.0,0,0,,0,0.0,32,150,4.7,2,,michel-dukes-1
503,Joey Gatewood*,Auburn,SEC,7,29,148,5.1,3,21.1,0,0,,0,0.0,29,148,5.1,3,,joey-gatewood-1
504,Tyler Burns*,Kansas State,Big 12,13,26,148,5.7,2,11.4,0,0,,0,0.0,26,148,5.7,2,,tyler-burns-1
505,Deangleo Antoine*,Florida Atlantic,CUSA,13,8,146,18.3,1,11.2,61,771,12.6,5,59.3,69,917,13.3,6,,deangleo-antoine-1
506,Jabir Frye,Troy,Sun Belt,8,33,146,4.4,2,18.3,10,90,9.0,0,11.3,43,236,5.5,2,,jabir-frye-1
507,Jaxson Kincaide*,Nevada,MWC,4,32,146,4.6,1,36.5,8,61,7.6,0,15.3,40,207,5.2,1,,jaxson-kincaide-1
508,Tyler Nevens,San Jose State,MWC,11,42,145,3.5,1,13.2,3,15,5.0,0,1.4,45,160,3.6,1,,tyler-nevens-1
509,Willie Parker*,Eastern Michigan,MAC,11,38,142,3.7,2,12.9,2,-1,-0.5,0,-0.1,40,141,3.5,2,,willie-parker-2
510,Willie Johnson*,Marshall,CUSA,13,8,141,17.6,2,10.8,13,349,26.8,4,26.8,21,490,23.3,6,,willie-johnson-5
511,Jahquez Evans,South Florida,American,8,19,140,7.4,1,17.5,0,0,,0,0.0,19,140,7.4,1,,jahquez-evans-1
512,Jaren Hall*,BYU,Ind,7,29,139,4.8,3,19.9,0,0,,0,0.0,29,139,4.8,3,,jaren-hall-1
513,Aron Cruickshank*,Wisconsin,Big Ten,14,13,138,10.6,1,9.9,3,29,9.7,0,2.1,16,167,10.4,1,,aron-cruickshank-1
514,Brandon Robinson*,Liberty,Ind,5,17,138,8.1,3,27.6,0,0,,0,0.0,17,138,8.1,3,,brandon-robinson-3
515,Cristian Solano*,Nevada,MWC,11,26,138,5.3,0,12.5,0,0,,0,0.0,26,138,5.3,0,,cristian-solano-1
516,Peter Hayes-Patrick,Akron,MAC,7,41,138,3.4,0,19.7,2,18,9.0,0,2.6,43,156,3.6,0,,peter-hayes-patrick-1
517,Velton Gardner,Kansas,Big 12,10,26,138,5.3,2,13.8,6,24,4.0,0,2.4,32,162,5.1,2,,velton-gardner-1
518,Jashaun Corbin*,Texas A&M,SEC,2,35,137,3.9,1,68.5,6,16,2.7,1,8.0,41,153,3.7,2,,jashaun-corbin-1
519,Kaleb Barker,Troy,Sun Belt,12,86,137,1.6,2,11.4,0,0,,0,0.0,86,137,1.6,2,,kaleb-barker-1
520,Nashon Ellerbe,Rice,CUSA,12,28,137,4.9,1,11.4,2,12,6.0,0,1.0,30,149,5.0,1,,nashon-ellerbe-1
521,Darien Rencher*,Clemson,ACC,15,26,135,5.2,2,9.0,4,26,6.5,0,1.7,30,161,5.4,2,,darien-rencher-1
522,Deonte Sheffield*,Florida State,ACC,4,27,135,5.0,1,33.8,1,1,1.0,0,0.3,28,136,4.9,1,,deonte-sheffield-1
523,Matt Corral,Ole Miss,SEC,10,57,135,2.4,1,13.5,0,0,,0,0.0,57,135,2.4,1,,matt-corral-1
524,Robert Washington,Old Dominion,CUSA,12,49,135,2.8,2,11.3,5,20,4.0,0,1.7,54,155,2.9,2,,robert-washington-2
525,Steele Chambers*,Ohio State,Big Ten,4,19,135,7.1,1,33.8,0,0,,0,0.0,19,135,7.1,1,,steele-chambers-1
526,Ryan Graham*,Arkansas State,Sun Belt,4,23,134,5.8,2,33.5,1,13,13.0,0,3.3,24,147,6.1,2,,ryan-graham-2
527,Mike Schmidt*,Air Force,MWC,6,17,133,7.8,3,22.2,0,0,,0,0.0,17,133,7.8,3,,mike-schmidt-2
528,TJ Wisham Jr.*,Louisiana,Sun Belt,14,15,133,8.9,0,9.5,0,0,,0,0.0,15,133,8.9,0,,tj-wisham-jr-2
529,Tayvion Robinson*,Virginia Tech,ACC,13,11,132,12.0,0,10.2,31,404,13.0,1,31.1,42,536,12.8,1,,tayvion-robinson-1
530,Myles Fells*,Navy,American,13,18,130,7.2,0,10.0,3,11,3.7,0,0.8,21,141,6.7,0,,myles-fells-1
531,Phil Jurkovec*,Notre Dame,Ind,7,22,130,5.9,0,18.6,0,0,,0,0.0,22,130,5.9,0,,phil-jurkovec-1
532,Anthony Brown*,Boston College,ACC,6,33,128,3.9,2,21.3,1,30,30.0,1,5.0,34,158,4.6,3,,anthony-brown-11
533,Jesse Brown,Northwestern,Big Ten,4,21,127,6.0,0,31.8,1,23,23.0,0,5.8,22,150,6.8,0,,jesse-brown-3
534,Josh Henderson*,North Carolina,ACC,8,18,127,7.1,0,15.9,0,0,,0,0.0,18,127,7.1,0,,josh-henderson-2
535,Tayvon Ruley*,Temple,American,9,24,127,5.3,1,14.1,1,7,7.0,0,0.8,25,134,5.4,1,,tayvon-ruley-1
536,Frank Harris,UTSA,CUSA,4,39,126,3.2,0,31.5,0,0,,0,0.0,39,126,3.2,0,,frank-harris-3
537,Kelton Moore*,Nevada,MWC,10,34,126,3.7,2,12.6,6,17,2.8,0,1.7,40,143,3.6,2,,kelton-moore-1
538,Gilberto Torres,Massachusetts,Ind,5,33,125,3.8,1,25.0,0,0,,0,0.0,33,125,3.8,1,,gilberto-torres-1
539,Jamious Griffin,Georgia Tech,ACC,9,37,125,3.4,0,13.9,2,11,5.5,0,1.2,39,136,3.5,0,,jamious-griffin-1
540,Coco Azema,Northwestern,Big Ten,4,7,123,17.6,1,30.8,0,0,,0,0.0,7,123,17.6,1,,coco-azema-1
541,Jacob Kibodi*,Texas A&M,SEC,7,31,123,4.0,1,17.6,6,37,6.2,0,5.3,37,160,4.3,1,,jacob-kibodi-1
542,Demario McCall*,Ohio State,Big Ten,13,18,122,6.8,2,9.4,4,28,7.0,0,2.2,22,150,6.8,2,,demario-mccall-1
543,Jacardia Wright*,Kansas State,Big 12,3,22,122,5.5,1,40.7,0,0,,0,0.0,22,122,5.5,1,,jacardia-wright-1
544,Jafar Armstrong*,Notre Dame,Ind,8,46,122,2.7,1,15.3,13,97,7.5,0,12.1,59,219,3.7,1,,jafar-armstrong-1
545,Jafar Armstrong*,Notre Dame,Ind,9,46,122,2.7,1,13.6,13,97,7.5,0,10.8,59,219,3.7,1,,jafar-armstrong-2
546,Tommy Devito,Syracuse,ACC,12,112,122,1.1,2,10.2,1,4,4.0,0,0.3,113,126,1.1,2,,tommy-devito-1
547,Kevin Brown,Massachusetts,Ind,3,27,119,4.4,1,39.7,0,0,,0,0.0,27,119,4.4,1,,kevin-brown-17
548,Michael Penix Jr.*,Indiana,Big Ten,6,22,119,5.4,2,19.8,0,-26,,0,-4.3,22,93,4.2,2,,michael-penix-jr-1
549,Tyler Allgeier*,BYU,Ind,13,17,119,7.0,0,9.2,3,67,22.3,1,5.2,20,186,9.3,1,,tyler-allgeier-1
550,Tyler Vitt,Texas State,Sun Belt,9,56,119,2.1,0,13.2,1,8,8.0,1,0.9,57,127,2.2,1,,tyler-vitt-1
551,Anthony Schwartz*,Auburn,SEC,13,11,118,10.7,2,9.1,41,440,10.7,1,33.8,52,558,10.7,3,,anthony-schwartz-1
552,Anthony Williams Jr.*,Michigan State,Big Ten,12,38,118,3.1,1,9.8,6,77,12.8,0,6.4,44,195,4.4,1,,anthony-williams-jr-1
553,Michiah Burton,Akron,MAC,11,38,117,3.1,1,10.6,5,37,7.4,0,3.4,43,154,3.6,1,,michiah-burton-1
554,Blake Watson,Old Dominion,CUSA,11,25,116,4.6,1,10.5,13,79,6.1,0,7.2,38,195,5.1,1,,blake-watson-2
555,Bradrick Shaw*,Wisconsin,Big Ten,9,18,116,6.4,1,12.9,0,0,,0,0.0,18,116,6.4,1,,bradrick-shaw-1
556,Kato Nelson,Akron,MAC,10,109,116,1.1,0,11.6,0,0,,0,0.0,109,116,1.1,0,,kato-nelson-1
557,Robert Burns*,Miami (FL),ACC,6,29,116,4.0,0,19.3,2,21,10.5,1,3.5,31,137,4.4,1,,robert-burns-1
558,Robert Burns*,Miami (FL),ACC,12,29,116,4.0,0,9.7,2,21,10.5,1,1.8,31,137,4.4,1,,robert-burns-2
559,Ryan Agnew*,San Diego State,MWC,12,72,116,1.6,1,9.7,1,-9,-9.0,0,-0.8,73,107,1.5,1,,ryan-agnew-1
560,Kene Nwangwu*,Iowa State,Big 12,13,16,115,7.2,0,8.8,1,8,8.0,0,0.6,17,123,7.2,0,,kene-nwangwu-1
561,Jerome Ford*,Alabama,SEC,4,24,114,4.8,3,28.5,2,11,5.5,0,2.8,26,125,4.8,3,,jerome-ford-1
562,Juma Otoviano,Rice,CUSA,3,37,114,3.1,0,38.0,3,37,12.3,0,12.3,40,151,3.8,0,,juma-otoviano-1
563,Zack Dobson,Middle Tennessee State,CUSA,8,17,113,6.6,0,14.1,16,242,15.1,3,30.3,33,355,10.8,3,,zack-dobson-1
564,Zack Dobson,Middle Tennessee State,CUSA,8,17,113,6.6,0,14.1,16,242,15.1,3,30.3,33,355,10.8,3,,zack-dobson-2
565,Mike Hollins*,Virginia,ACC,13,21,112,5.3,3,8.6,0,0,,0,0.0,21,112,5.3,3,,mike-hollins-1
566,Deon McIntosh*,Washington State,Pac-12,13,16,111,6.9,1,8.5,17,113,6.6,2,8.7,33,224,6.8,3,,deon-mcintosh-1
567,Deshaun Fenwick,South Carolina,SEC,5,22,111,5.0,0,22.2,0,0,,0,0.0,22,111,5.0,0,,deshaun-fenwick-1
568,Jaylen Dixon*,Utah,Pac-12,14,18,111,6.2,2,7.9,24,343,14.3,1,24.5,42,454,10.8,3,,jaylen-dixon-1
569,Danny Davis*,Wisconsin,Big Ten,14,9,110,12.2,1,7.9,30,250,8.3,1,17.9,39,360,9.2,2,,danny-davis-5
570,Kaegun Williams*,San Diego State,MWC,10,30,110,3.7,0,11.0,4,27,6.8,0,2.7,34,137,4.0,0,,kaegun-williams-1
571,Kenny Pickett*,Pitt,ACC,12,95,110,1.2,2,9.2,1,3,3.0,1,0.3,96,113,1.2,3,,kenny-pickett-1
572,Isaac Ruoss*,Navy,American,10,29,109,3.8,1,10.9,0,0,,0,0.0,29,109,3.8,1,,isaac-ruoss-1
573,Ihmir Smith-Marsette*,Iowa,Big Ten,13,11,108,9.8,3,8.3,44,722,16.4,5,55.5,55,830,15.1,8,,ihmir-smith-marsette-1
574,Dakereon Joyner,South Carolina,SEC,8,29,107,3.7,1,13.4,6,46,7.7,0,5.8,35,153,4.4,1,,dakereon-joyner-1
575,Nic Smith,North Texas,CUSA,11,33,107,3.2,0,9.7,15,107,7.1,0,9.7,48,214,4.5,0,,nic-smith-1
576,B.J. Smith,Troy,Sun Belt,2,11,106,9.6,1,53.0,2,14,7.0,0,7.0,13,120,9.2,1,,bj-smith-1
577,Gerald Green*,Georgia Southern,Sun Belt,4,21,106,5.0,0,26.5,0,0,,0,0.0,21,106,5.0,0,,gerald-green-5
578,Michael Wiley,Arizona,Pac-12,12,31,106,3.4,0,8.8,18,165,9.2,0,13.8,49,271,5.5,0,,michael-wiley-3
579,Noah Vedral,Nebraska,Big Ten,6,30,106,3.5,3,17.7,1,22,22.0,0,3.7,31,128,4.1,3,,noah-vedral-1
580,Ryan Montgomery*,Cincinnati,American,14,20,106,5.3,2,7.6,0,0,,0,0.0,20,106,5.3,2,,ryan-montgomery-1
581,Jamontez Woods,Troy,Sun Belt,4,22,105,4.8,0,26.3,0,0,,0,0.0,22,105,4.8,0,,jamontez-woods-1
582,Jawhar Jordan,Syracuse,ACC,4,15,105,7.0,1,26.3,2,87,43.5,0,21.8,17,192,11.3,1,,jawhar-jordan-1
583,Shane Buechele*,SMU,American,13,64,105,1.6,2,8.1,0,0,,0,0.0,64,105,1.6,2,,shane-buechele-1
584,Aleva Hifo*,BYU,Ind,12,23,104,4.5,2,8.7,42,483,11.5,3,40.3,65,587,9.0,5,,aleva-hifo-1
585,Jawon Pass*,Louisville,ACC,2,20,104,5.2,2,52.0,1,-5,-5.0,0,-2.5,21,99,4.7,2,,jawon-pass-1
586,Lance Legendre,Maryland,Big Ten,3,13,104,8.0,0,34.7,0,0,,0,0.0,13,104,8.0,0,,lance-legendre-1
587,Johnny Ford,South Florida,American,4,19,103,5.4,2,25.8,13,149,11.5,2,37.3,32,252,7.9,4,,johnny-ford-1
588,Qualan Jones*,Baylor,Big 12,4,13,103,7.9,2,25.8,0,0,,0,0.0,13,103,7.9,2,,qualan-jones-1
589,Travis Levy*,Boston College,ACC,13,28,103,3.7,1,7.9,2,12,6.0,0,0.9,30,115,3.8,1,,travis-levy-1
590,Brant Kuithe*,Utah,Pac-12,14,6,102,17.0,3,7.3,34,602,17.7,6,43.0,40,704,17.6,9,,brant-kuithe-1
591,Breck Turner*,Eastern Michigan,MAC,12,36,102,2.8,0,8.5,14,100,7.1,0,8.3,50,202,4.0,0,,breck-turner-1
592,Isaiah Phillips,Louisiana-Monroe,Sun Belt,7,28,102,3.6,0,14.6,2,34,17.0,0,4.9,30,136,4.5,0,,isaiah-phillips-1
593,Jerry Howard,Georgia Tech,ACC,12,23,102,4.4,0,8.5,6,92,15.3,1,7.7,29,194,6.7,1,,jerry-howard-2
594,Josh Hammond*,Florida,SEC,13,6,101,16.8,1,7.8,27,346,12.8,2,26.6,33,447,13.5,3,,josh-hammond-1
595,Lee Witherspoon*,Mississippi State,SEC,11,22,101,4.6,1,9.2,3,19,6.3,0,1.7,25,120,4.8,1,,lee-witherspoon-1
596,Raymond Niro III,Northwestern,Big Ten,11,11,101,9.2,1,9.2,0,0,,0,0.0,11,101,9.2,1,,raymond-niro-iii-1
597,Alex Delton,TCU,Big 12,6,17,100,5.9,0,16.7,0,0,,0,0.0,17,100,5.9,0,,alex-delton-1
598,Austin Burton,UCLA,Pac-12,6,23,100,4.3,1,16.7,0,0,,0,0.0,23,100,4.3,1,,austin-burton-1
599,Chase Cord*,Boise State,MWC,9,25,100,4.0,2,11.1,0,0,,0,0.0,25,100,4.0,2,,chase-cord-1
600,Kentrail Moran,New Mexico,MWC,6,27,100,3.7,2,16.7,0,0,,0,0.0,27,100,3.7,2,,kentrail-moran-1
601,Re-al Mitchell*,Iowa State,Big 12,5,11,100,9.1,1,20.0,1,3,3.0,0,0.6,12,103,8.6,1,,re-al-mitchell-1
602,Christian Hunter,Colorado State,MWC,10,24,99,4.1,1,9.9,3,8,2.7,0,0.8,27,107,4.0,1,,christian-hunter-1
603,Darwin Barlow,TCU,Big 12,3,22,99,4.5,1,33.0,1,10,10.0,0,3.3,23,109,4.7,1,,darwin-barlow-1
604,DJ Chatman*,Arkansas State,Sun Belt,8,26,99,3.8,0,12.4,1,7,7.0,0,0.9,27,106,3.9,0,,dj-chatman-1
605,Seth Green*,Minnesota,Big Ten,12,29,99,3.4,5,8.3,1,8,8.0,0,0.7,30,107,3.6,5,,seth-green-1
606,Ron Cook Jr.*,Buffalo,MAC,12,18,96,5.3,1,8.0,5,40,8.0,0,3.3,23,136,5.9,1,,ron-cook-jr-1
607,Sheldon Croney Jr.*,Iowa State,Big 12,12,30,96,3.2,1,8.0,10,60,6.0,0,5.0,40,156,3.9,1,,sheldon-croney-jr-1
608,Cade Barnard,Army,Ind,8,18,95,5.3,2,11.9,0,0,,0,0.0,18,95,5.3,2,,cade-barnard-1
609,Joe Ervin*,Kansas State,Big 12,4,23,95,4.1,1,23.8,0,0,,0,0.0,23,95,4.1,1,,joe-ervin-1
610,Chase Brice*,Clemson,ACC,13,14,94,6.7,1,7.2,0,0,,0,0.0,14,94,6.7,1,,chase-brice-1
611,Derrick Vickers*,Utah,Pac-12,14,20,94,4.7,1,6.7,19,202,10.6,0,14.4,39,296,7.6,1,,derrick-vickers-2
612,Harold Joiner*,Auburn,SEC,13,12,94,7.8,1,7.2,6,128,21.3,1,9.8,18,222,12.3,2,,harold-joiner-1
613,Jakari Norwood*,Illinois,Big Ten,6,15,94,6.3,0,15.7,2,-1,-0.5,0,-0.2,17,93,5.5,0,,jakari-norwood-1
614,Matt Myers*,Buffalo,MAC,5,30,94,3.1,2,18.8,0,0,,0,0.0,30,94,3.1,2,,matt-myers-2
615,Ygenio Booker*,Tulane,American,10,18,94,5.2,1,9.4,8,74,9.3,1,7.4,26,168,6.5,2,,ygenio-booker-1
616,Tre Tucker*,Cincinnati,American,14,8,93,11.6,0,6.6,7,92,13.1,0,6.6,15,185,12.3,0,,tre-tucker-1
617,Austin Kendall,West Virginia,Big 12,9,45,91,2.0,1,10.1,0,0,,0,0.0,45,91,2.0,1,,austin-kendall-1
618,Deltron Sands,Akron,MAC,6,35,91,2.6,1,15.2,6,31,5.2,0,5.2,41,122,3.0,1,,deltron-sands-1
619,Tyler King*,Marshall,CUSA,2,15,91,6.1,0,45.5,4,28,7.0,0,14.0,19,119,6.3,0,,tyler-king-4
620,DeQuan Finn,Toledo,MAC,3,15,90,6.0,0,30.0,0,0,,0,0.0,15,90,6.0,0,,dequan-finn-1
621,Darius Wade,Bowling Green,MAC,7,31,89,2.9,0,12.7,0,0,,0,0.0,31,89,2.9,0,,darius-wade-1
622,Jalen Reagor,TCU,Big 12,12,14,89,6.4,0,7.4,43,611,14.2,5,50.9,57,700,12.3,5,,jalen-reagor-1
623,Lew Nichols*,Central Michigan,MAC,4,19,89,4.7,0,22.3,0,0,,0,0.0,19,89,4.7,0,,lew-nichols-1
624,Marquez Stevenson,Houston,American,12,9,89,9.9,0,7.4,52,907,17.4,9,75.6,61,996,16.3,9,,marquez-stevenson-1
625,Riley Burt*,Utah State,MWC,11,26,89,3.4,0,8.1,4,22,5.5,0,2.0,30,111,3.7,0,,riley-burt-1
626,Sam Hartman*,Wake Forest,ACC,4,27,89,3.3,1,22.3,0,0,,0,0.0,27,89,3.3,1,,sam-hartman-1
627,Tyler Simmons*,Georgia,SEC,14,12,89,7.4,0,6.4,21,255,12.1,1,18.2,33,344,10.4,1,,tyler-simmons-2
628,Evan Conley*,Louisville,ACC,7,30,88,2.9,1,12.6,0,0,,0,0.0,30,88,2.9,1,,evan-conley-1
629,Jakobi Buchanan,Army,Ind,3,19,88,4.6,0,29.3,0,0,,0,0.0,19,88,4.6,0,,jakobi-buchanan-1
630,Raheem Blackshear,Rutgers,Big Ten,4,29,88,3.0,0,22.0,29,310,10.7,2,77.5,58,398,6.9,2,,raheem-blackshear-1
631,Daniel Leconte*,Florida Atlantic,CUSA,13,26,87,3.3,0,6.7,0,0,,0,0.0,26,87,3.3,0,,daniel-leconte-1
632,Marcus Jones,Northern Illinois,MAC,12,24,87,3.6,1,7.3,15,134,8.9,0,11.2,39,221,5.7,1,,marcus-jones-9
633,Taye Barber,TCU,Big 12,9,5,87,17.4,0,9.7,29,372,12.8,0,41.3,34,459,13.5,0,,taye-barber-1
634,Troy Henderson*,Liberty,Ind,8,10,87,8.7,1,10.9,3,33,11.0,2,4.1,13,120,9.2,3,,troy-henderson-2
635,Malik Davis*,Florida,SEC,12,34,86,2.5,1,7.2,6,41,6.8,0,3.4,40,127,3.2,1,,malik-davis-1
636,Caleb Steward*,Virginia Tech,ACC,5,19,85,4.5,0,17.0,0,0,,0,0.0,19,85,4.5,0,,caleb-steward-1
637,Hekili Keliljiki*,Hawaii,MWC,15,17,85,5.0,0,5.7,0,0,,0,0.0,17,85,5.0,0,,hekili-keliljiki-1
638,Rodrigues Clark*,Memphis,American,8,26,85,3.3,1,10.6,0,0,,0,0.0,26,85,3.3,1,,rodrigues-clark-1
639,Micah Gray,New Mexico,MWC,12,16,84,5.3,1,7.0,0,0,,0,0.0,16,84,5.3,1,,micah-gray-1
640,Andrew Peasley*,Utah State,MWC,1,3,83,27.7,1,83.0,0,0,,0,0.0,3,83,27.7,1,,andrew-peasley-1
641,Ashton Johnson*,Louisiana,Sun Belt,14,12,83,6.9,1,5.9,0,0,,0,0.0,12,83,6.9,1,,ashton-johnson-1
642,Kawaan Baker,South Alabama,Sun Belt,12,20,83,4.2,2,6.9,35,574,16.4,3,47.8,55,657,11.9,5,,kawaan-baker-1
643,Kumehnnu Gwilly*,Central Michigan,MAC,8,24,83,3.5,0,10.4,0,0,,0,0.0,24,83,3.5,0,,kumehnnu-gwilly-1
644,Peytton Pickett*,Liberty,Ind,12,24,83,3.5,2,6.9,6,71,11.8,0,5.9,30,154,5.1,2,,peytton-pickett-1
645,Shocky Jacques-Louis*,Pitt,ACC,12,13,83,6.4,0,6.9,23,348,15.1,2,29.0,36,431,12.0,2,,shocky-jacques-louis-1
646,Elijah Barnwell,Rutgers,Big Ten,11,10,81,8.1,0,7.4,1,8,8.0,0,0.7,11,89,8.1,0,,elijah-barnwell-1
647,Kalil Pimpleton*,Central Michigan,MAC,14,7,81,11.6,0,5.8,82,894,10.9,6,63.9,89,975,11.0,6,,kalil-pimpleton-1
648,Markis McCray,Louisiana-Monroe,Sun Belt,12,8,81,10.1,0,6.8,48,583,12.1,6,48.6,56,664,11.9,6,,markis-mccray-1
649,Michael Curtis,Massachusetts,Ind,3,22,81,3.7,1,27.0,0,0,,0,0.0,22,81,3.7,1,,michael-curtis-2
650,Sean Dollars*,Oregon,Pac-12,4,7,81,11.6,0,20.3,2,1,0.5,0,0.3,9,82,9.1,0,,sean-dollars-1
651,Jack Lindsey,Arkansas,SEC,11,7,80,11.4,0,7.3,0,0,,0,0.0,7,80,11.4,0,,jack-lindsey-1
652,Jacquez Sloan*,Western Kentucky,CUSA,13,8,80,10.0,2,6.2,34,297,8.7,1,22.8,42,377,9.0,3,,jacquez-sloan-1
653,Jason Bean,North Texas,CUSA,7,14,80,5.7,0,11.4,0,0,,0,0.0,14,80,5.7,0,,jason-bean-1
654,Perry Olsen*,Navy,American,8,34,80,2.4,2,10.0,0,0,,0,0.0,34,80,2.4,2,,perry-olsen-1
655,RB Marlow III,Bowling Green,MAC,12,15,80,5.3,0,6.7,22,217,9.9,0,18.1,37,297,8.0,0,,rb-marlow-iii-1
656,Ronnie Walker Jr.*,Indiana,Big Ten,13,27,80,3.0,0,6.2,12,112,9.3,1,8.6,39,192,4.9,1,,ronnie-walker-jr-1
657,Connor Heyward*,Michigan State,Big Ten,4,24,79,3.3,0,19.8,7,52,7.4,1,13.0,31,131,4.2,1,,connor-heyward-1
658,Darran Williams,Nevada-Las Vegas,MWC,5,25,79,3.2,1,15.8,2,11,5.5,0,2.2,27,90,3.3,1,,darran-williams-1
659,Dillon Gabriel*,UCF,American,13,71,78,1.1,4,6.0,0,0,,0,0.0,71,78,1.1,4,,dillon-gabriel-1
660,Traveon Samuel*,Memphis,American,14,15,78,5.2,0,5.6,6,26,4.3,0,1.9,21,104,5.0,0,,traveon-samuel-1
661,Tyleek Collins,Nevada-Las Vegas,MWC,9,14,78,5.6,0,8.7,15,79,5.3,0,8.8,29,157,5.4,0,,tyleek-collins-1
662,Deven Thompkins*,Utah State,MWC,12,6,77,12.8,1,6.4,40,536,13.4,4,44.7,46,613,13.3,5,,deven-thompkins-1
663,Jack Abraham*,Southern Mississippi,CUSA,13,81,77,1.0,6,5.9,1,9,9.0,0,0.7,82,86,1.0,6,,jack-abraham-1
664,Dorian Maddox,Stanford,Pac-12,8,22,75,3.4,0,9.4,4,37,9.3,0,4.6,26,112,4.3,0,,dorian-maddox-1
665,Henry Ruggs III*,Alabama,SEC,12,2,75,37.5,1,6.3,40,746,18.7,7,62.2,42,821,19.5,8,,henry-ruggs-iii-1
666,Malik Hancock,Army,Ind,12,10,75,7.5,1,6.3,3,78,26.0,1,6.5,13,153,11.8,2,,malik-hancock-1
667,Wyatt Mazour,Nebraska,Big Ten,10,21,74,3.5,1,7.4,5,52,10.4,0,5.2,26,126,4.8,1,,wyatt-mazour-1
668,Lamont Atkins*,Virginia,ACC,14,15,73,4.9,1,5.2,8,61,7.6,0,4.4,23,134,5.8,1,,lamont-atkins-1
669,Patrick Garwo*,Boston College,ACC,4,18,73,4.1,0,18.3,3,8,2.7,0,2.0,21,81,3.9,0,,patrick-garwo-1
670,Brett Gabbert*,Miami (OH),MAC,14,88,72,0.8,3,5.1,0,0,,0,0.0,88,72,0.8,3,,brett-gabbert-1
671,Isaiah Sanders*,Air Force,MWC,5,10,72,7.2,0,14.4,0,0,,0,0.0,10,72,7.2,0,,isaiah-sanders-1
672,Martell Pettaway,West Virginia,Big 12,4,27,72,2.7,2,18.0,2,7,3.5,0,1.8,29,79,2.7,2,,martell-pettaway-1
673,John Holcombe II*,Kansas State,Big 12,3,13,71,5.5,0,23.7,0,0,,0,0.0,13,71,5.5,0,,john-holcombe-ii-1
674,Tyjon Lindsey,Oregon State,Pac-12,10,8,71,8.9,1,7.1,18,209,11.6,2,20.9,26,280,10.8,3,,tyjon-lindsey-1
675,Zach Kahn*,Miami (OH),MAC,13,23,71,3.1,1,5.5,0,0,,0,0.0,23,71,3.1,1,,zach-kahn-1
676,Chance Warren*,Navy,American,12,5,70,14.0,2,5.8,6,91,15.2,1,7.6,11,161,14.6,3,,chance-warren-1
677,Lorenzo Harrison,Maryland,Big Ten,2,7,70,10.0,0,35.0,0,0,,0,0.0,7,70,10.0,0,,lorenzo-harrison-1
678,Malik Knowles*,Kansas State,Big 12,11,7,70,10.0,0,6.4,27,397,14.7,3,36.1,34,467,13.7,3,,malik-knowles-1
679,Micah Kelly,Toledo,MAC,2,6,70,11.7,1,35.0,0,0,,0,0.0,6,70,11.7,1,,micah-kelly-1
680,Giles Jackson*,Michigan,Big Ten,13,10,69,6.9,1,5.3,9,142,15.8,1,10.9,19,211,11.1,2,,giles-jackson-1
681,Hank Bachmeier*,Boise State,MWC,8,41,69,1.7,1,8.6,0,0,,0,0.0,41,69,1.7,1,,hank-bachmeier-1
682,Calvin Tyler Jr.,Oregon State,Pac-12,3,12,68,5.7,0,22.7,1,15,15.0,1,5.0,13,83,6.4,1,,calvin-tyler-jr-1
683,Carter Stanley,Kansas,Big 12,12,67,68,1.0,1,5.7,0,0,,0,0.0,67,68,1.0,1,,carter-stanley-1
684,Deion Smith,Colorado,Pac-12,12,23,68,3.0,0,5.7,4,28,7.0,0,2.3,27,96,3.6,0,,deion-smith-1
685,Feleipe Franks*,Florida,SEC,4,21,68,3.2,1,17.0,0,0,,0,0.0,21,68,3.2,1,,feleipe-franks-1
686,Hussein Howe,East Carolina,American,4,20,68,3.4,0,17.0,2,30,15.0,0,7.5,22,98,4.5,0,,hussein-howe-1
687,TJ Green*,Utah,Pac-12,13,23,68,3.0,1,5.2,0,0,,0,0.0,23,68,3.0,1,,tj-green-4
688,Trevon Raymore,Bowling Green,MAC,3,23,68,3.0,0,22.7,0,0,,0,0.0,23,68,3.0,0,,trevon-raymore-1
689,Dayton Furuta*,Hawaii,MWC,7,13,67,5.2,1,9.6,6,24,4.0,0,3.4,19,91,4.8,1,,dayton-furuta-1
690,Dylan McCaffrey*,Michigan,Big Ten,7,13,67,5.2,1,9.6,1,1,1.0,0,0.1,14,68,4.9,1,,dylan-mccaffrey-1
691,Daimarqua Foster,TCU,Big 12,1,8,66,8.3,1,66.0,0,0,,0,0.0,8,66,8.3,1,,daimarqua-foster-1
692,Khalil Shakir*,Boise State,MWC,14,19,66,3.5,3,4.7,63,872,13.8,6,62.3,82,938,11.4,9,,khalil-shakir-1
693,Dontae Smith,Georgia Tech,ACC,8,10,65,6.5,0,8.1,2,13,6.5,0,1.6,12,78,6.5,0,,dontae-smith-1
694,Emari Demercado,TCU,Big 12,4,18,65,3.6,0,16.3,0,0,,0,0.0,18,65,3.6,0,,emari-demercado-1
695,John Chenal*,Wisconsin,Big Ten,14,18,65,3.6,1,4.6,3,15,5.0,0,1.1,21,80,3.8,1,,john-chenal-1
696,T.J. Hammonds,Arkansas,SEC,5,8,65,8.1,0,13.0,4,10,2.5,0,2.0,12,75,6.3,0,,tj-hammonds-1
697,T.J. Pledger*,Oklahoma,Big 12,10,10,65,6.5,1,6.5,1,0,0.0,0,0.0,11,65,5.9,1,,tj-pledger-1
698,Hunter Johnson,Northwestern,Big Ten,7,48,64,1.3,1,9.1,0,5,,0,0.7,48,69,1.4,1,,hunter-johnson-2
699,Kyle Vantrease*,Buffalo,MAC,13,25,64,2.6,6,4.9,0,0,,0,0.0,25,64,2.6,6,,kyle-vantrease-1
700,Rahmir Johnson,Nebraska,Big Ten,5,21,64,3.0,1,12.8,1,12,12.0,0,2.4,22,76,3.5,1,,rahmir-johnson-1
701,Blake Barnett,South Florida,American,4,23,63,2.7,0,15.8,0,0,,0,0.0,23,63,2.7,0,,blake-barnett-2
702,Daniel Young*,Texas,Big 12,9,16,63,3.9,2,7.0,2,7,3.5,0,0.8,18,70,3.9,2,,daniel-young-1
703,Dom Williams,Kansas,Big 12,4,20,63,3.2,0,15.8,0,0,,0,0.0,20,63,3.2,0,,dom-williams-2
704,Kazmeir Allen,UCLA,Pac-12,4,13,63,4.8,0,15.8,4,29,7.3,0,7.3,17,92,5.4,0,,kazmeir-allen-1
705,Matt McKay,North Carolina State,ACC,6,25,63,2.5,4,10.5,0,0,,0,0.0,25,63,2.5,4,,matt-mckay-1
706,Woody Barrett*,Kent State,MAC,9,22,63,2.9,0,7.0,2,13,6.5,0,1.4,24,76,3.2,0,,woody-barrett-2
707,Jsi Hatfield,East Carolina,American,12,13,62,4.8,0,5.2,16,260,16.3,2,21.7,29,322,11.1,2,,jsi-hatfield-1
708,Smoke Harris*,Louisiana Tech,CUSA,13,11,61,5.5,1,4.7,47,348,7.4,2,26.8,58,409,7.1,3,,smoke-harris-1
709,Aaron Bedgood,Coastal Carolina,Sun Belt,5,4,60,15.0,0,12.0,8,76,9.5,1,15.2,12,136,11.3,1,,aaron-bedgood-1
710,Amon-Ra St. Brown*,USC,Pac-12,13,7,60,8.6,1,4.6,77,1042,13.5,6,80.2,84,1102,13.1,7,,amon-ra-st-brown-1
711,B.J. Daniels,UTSA,CUSA,12,11,60,5.5,0,5.0,0,0,,0,0.0,11,60,5.5,0,,bj-daniels-2
712,Deven Boston,UTSA,CUSA,4,14,60,4.3,1,15.0,2,7,3.5,0,1.8,16,67,4.2,1,,deven-boston-1
713,Keyon Lesane,North Carolina State,ACC,10,5,60,12.0,0,6.0,13,93,7.2,0,9.3,18,153,8.5,0,,keyon-lesane-1
714,Baylor Romney*,BYU,Ind,4,24,59,2.5,0,14.8,1,13,13.0,0,3.3,25,72,2.9,0,,baylor-romney-1
715,Kadarius Toney*,Florida,SEC,7,12,59,4.9,0,8.4,10,194,19.4,1,27.7,22,253,11.5,1,,kadarius-toney-1
716,Clayton Welch,Syracuse,ACC,9,20,58,2.9,0,6.4,0,0,,0,0.0,20,58,2.9,0,,clayton-welch-1
717,Dante Black,Connecticut,American,7,13,58,4.5,0,8.3,1,6,6.0,0,0.9,14,64,4.6,0,,dante-black-2
718,K.J. Jefferson,Arkansas,SEC,3,30,58,1.9,2,19.3,1,-8,-8.0,0,-2.7,31,50,1.6,2,,kj-jefferson-1
719,Riley Neal,Vanderbilt,SEC,11,53,58,1.1,0,5.3,0,0,,0,0.0,53,58,1.1,0,,riley-neal-1
720,Eli Stove*,Auburn,SEC,13,7,57,8.1,1,4.4,37,321,8.7,3,24.7,44,378,8.6,4,,eli-stove-1
721,Nathaniel Peat,Stanford,Pac-12,12,9,57,6.3,0,4.8,5,43,8.6,0,3.6,14,100,7.1,0,,nathaniel-peat-1
722,Travis Tisdale*,Kentucky,SEC,2,5,57,11.4,1,28.5,0,0,,0,0.0,5,57,11.4,1,,travis-tisdale-1
723,Brian Maurer*,Tennessee,SEC,8,23,56,2.4,2,7.0,1,-2,-2.0,0,-0.3,24,54,2.3,2,,brian-maurer-1
724,Brittain Brown,Duke,ACC,3,12,56,4.7,0,18.7,2,13,6.5,0,4.3,14,69,4.9,0,,brittain-brown-1
725,Jack Plummer,Purdue,Big Ten,9,62,56,0.9,0,6.2,0,0,,0,0.0,62,56,0.9,0,,jack-plummer-1
726,KeShawn McClendon*,Western Kentucky,CUSA,5,9,56,6.2,0,11.2,0,0,,0,0.0,9,56,6.2,0,,keshawn-mcclendon-1
727,Taisun Phommachanh*,Clemson,ACC,3,12,56,4.7,0,18.7,0,0,,0,0.0,12,56,4.7,0,,taisun-phommachanh-1
728,Tucker Gregg*,Georgia State,Sun Belt,13,15,56,3.7,1,4.3,0,0,,0,0.0,15,56,3.7,1,,tucker-gregg-1
729,Joshua Youngblood*,Kansas State,Big 12,13,11,55,5.0,1,4.2,9,73,8.1,0,5.6,20,128,6.4,1,,joshua-youngblood-1
730,Trent Pennix,North Carolina State,ACC,10,13,55,4.2,0,5.5,7,80,11.4,1,8.0,20,135,6.8,1,,trent-pennix-1
731,Ainias Smith*,Texas A&M,SEC,12,7,54,7.7,0,4.5,22,248,11.3,3,20.7,29,302,10.4,3,,ainias-smith-1
732,Akilian Butler*,Boise State,MWC,14,8,54,6.8,1,3.9,28,316,11.3,2,22.6,36,370,10.3,3,,akilian-butler-1
733,Jarrett Guarantano*,Tennessee,SEC,13,49,54,1.1,0,4.2,0,0,,0,0.0,49,54,1.1,0,,jarrett-guarantano-1
734,Brandon Jones,UTEP,CUSA,6,38,53,1.4,1,8.8,0,0,,0,0.0,38,53,1.4,1,,brandon-jones-16
735,Chico McClatcher*,Washington,Pac-12,10,9,53,5.9,0,5.3,13,102,7.8,1,10.2,22,155,7.0,1,,chico-mcclatcher-1
736,Daevon Vigilant,New Mexico,MWC,10,17,53,3.1,1,5.3,4,11,2.8,0,1.1,21,64,3.0,1,,daevon-vigilant-1
737,David Ellis*,Indiana,Big Ten,13,9,53,5.9,1,4.1,16,173,10.8,0,13.3,25,226,9.0,1,,david-ellis-2
738,Enoch Nawahine*,Utah State,MWC,10,16,53,3.3,0,5.3,2,7,3.5,0,0.7,18,60,3.3,0,,enoch-nawahine-1
739,Tabari Hines,North Carolina State,ACC,12,3,53,17.7,0,4.4,37,402,10.9,2,33.5,40,455,11.4,2,,tabari-hines-1
740,Courtney Reese,Nevada-Las Vegas,MWC,5,11,52,4.7,1,10.4,3,14,4.7,0,2.8,14,66,4.7,1,,courtney-reese-1
741,Demetris Robertson*,Georgia,SEC,13,6,52,8.7,0,4.0,30,333,11.1,3,25.6,36,385,10.7,3,,demetris-robertson-1
742,Demetris Robertson*,Georgia,SEC,13,6,52,8.7,0,4.0,30,333,11.1,3,25.6,36,385,10.7,3,,demetris-robertson-2
743,Kalija Lipscomb,Vanderbilt,SEC,11,4,52,13.0,0,4.7,47,511,10.9,3,46.5,51,563,11.0,3,,kalija-lipscomb-1
744,Kenyon Sims*,Illinois,Big Ten,5,14,52,3.7,0,10.4,2,7,3.5,0,1.4,16,59,3.7,0,,kenyon-sims-1
745,Keon Howard*,Tulane,American,4,12,52,4.3,1,13.0,0,0,,0,0.0,12,52,4.3,1,,keon-howard-1
746,Tyler Markray*,Kentucky,SEC,1,2,52,26.0,1,52.0,0,0,,0,0.0,2,52,26.0,1,,tyler-markray-1
747,DeAndre' Delaney*,Wake Forest,ACC,9,19,51,2.7,0,5.7,0,0,,0,0.0,19,51,2.7,0,,deandre-delaney-1
748,De'Vion Warren,Arkansas,SEC,9,5,51,10.2,0,5.7,4,19,4.8,0,2.1,9,70,7.8,0,,devion-warren-1
749,Jauan Jennings*,Tennessee,SEC,13,13,51,3.9,1,3.9,59,969,16.4,8,74.5,72,1020,14.2,9,,jauan-jennings-1
750,Josh Foley,New Mexico State,Ind,2,7,51,7.3,0,25.5,0,0,,0,0.0,7,51,7.3,0,,josh-foley-1
751,Mason Stokke*,Wisconsin,Big Ten,12,15,51,3.4,2,4.3,6,47,7.8,0,3.9,21,98,4.7,2,,mason-stokke-1
752,Treyson Potts*,Minnesota,Big Ten,2,7,51,7.3,1,25.5,0,0,,0,0.0,7,51,7.3,1,,treyson-potts-1
753,Trivenskey Mosley*,Southern Mississippi,CUSA,5,10,51,5.1,0,10.2,5,33,6.6,0,6.6,15,84,5.6,0,,trivenskey-mosley-1
754,A.J. Carter*,Arizona State,Pac-12,13,19,50,2.6,0,3.8,2,25,12.5,0,1.9,21,75,3.6,0,,aj-carter-1
755,Amari Rodgers*,Clemson,ACC,14,2,50,25.0,1,3.6,30,426,14.2,4,30.4,32,476,14.9,5,,amari-rodgers-1
756,Justin Herbert*,Oregon,Pac-12,14,58,50,0.9,4,3.6,0,0,,0,0.0,58,50,0.9,4,,justin-herbert-1
757,Larry Wooden*,UAB,CUSA,10,14,50,3.6,0,5.0,4,9,2.3,0,0.9,18,59,3.3,0,,larry-wooden-1
758,Shea Patterson*,Michigan,Big Ten,13,87,50,0.6,5,3.8,0,0,,0,0.0,87,50,0.6,5,,shea-patterson-1
759,Bryson Smith,Houston,American,10,17,49,2.9,2,4.9,9,62,6.9,0,6.2,26,111,4.3,2,,bryson-smith-1
760,Derrion Grim,Fresno State,MWC,11,4,49,12.3,0,4.5,20,303,15.2,4,27.5,24,352,14.7,4,,derrion-grim-1
761,Jawaun Johnson*,Louisiana Tech,CUSA,2,8,49,6.1,1,24.5,0,0,,0,0.0,8,49,6.1,1,,jawaun-johnson-1
762,Lincoln Victor*,Hawaii,MWC,12,2,49,24.5,0,4.1,10,86,8.6,3,7.2,12,135,11.3,3,,lincoln-victor-1
763,Mitchell Pryor,Vanderbilt,SEC,9,5,49,9.8,1,5.4,0,0,,0,0.0,5,49,9.8,1,,mitchell-pryor-1
764,Tye Evans,Ball State,MAC,8,3,49,16.3,0,6.1,0,0,,0,0.0,3,49,16.3,0,,tye-evans-1
765,Brandon Wimbush*,UCF,American,5,11,48,4.4,0,9.6,0,0,,0,0.0,11,48,4.4,0,,brandon-wimbush-1
766,Brandon Wright*,Michigan State,Big Ten,6,18,48,2.7,0,8.0,0,0,,0,0.0,18,48,2.7,0,,brandon-wright-4
767,Isaiah Wright*,Temple,American,12,5,48,9.6,0,4.0,47,442,9.4,5,36.8,52,490,9.4,5,,isaiah-wright-1
768,Iverson Clement*,Florida,SEC,6,3,48,16.0,0,8.0,0,0,,0,0.0,3,48,16.0,0,,iverson-clement-1
769,Jackson Anthrop,Purdue,Big Ten,12,12,48,4.0,0,4.0,37,340,9.2,1,28.3,49,388,7.9,1,,jackson-anthrop-1
770,Jirehl Brock*,Iowa State,Big 12,4,9,48,5.3,0,12.0,0,0,,0,0.0,9,48,5.3,0,,jirehl-brock-1
771,Lexington Joseph*,Florida International,CUSA,6,10,48,4.8,0,8.0,0,0,,0,0.0,10,48,4.8,0,,lexington-joseph-1
772,Chris Katrenick,Duke,ACC,5,13,47,3.6,1,9.4,0,0,,0,0.0,13,47,3.6,1,,chris-katrenick-1
773,Isaiah Floyd*,Arizona State,Pac-12,3,11,47,4.3,0,15.7,0,0,,0,0.0,11,47,4.3,0,,isaiah-floyd-1
774,Keith Mixon*,Western Michigan,MAC,13,1,47,47.0,1,3.6,50,500,10.0,2,38.5,51,547,10.7,3,,keith-mixon-1
775,Micah Simon*,BYU,Ind,13,5,47,9.4,2,3.6,51,616,12.1,2,47.4,56,663,11.8,4,,micah-simon-1
776,Nolan Eriksen*,Air Force,MWC,9,7,47,6.7,1,5.2,0,0,,0,0.0,7,47,6.7,1,,nolan-eriksen-1
777,Will Jones,Ball State,MAC,12,9,47,5.2,0,3.9,7,37,5.3,0,3.1,16,84,5.3,0,,will-jones-3
778,Devin Leary,North Carolina State,ACC,8,40,46,1.2,0,5.8,0,0,,0,0.0,40,46,1.2,0,,devin-leary-1
779,Kyle Williams*,Arizona State,Pac-12,13,13,46,3.5,0,3.5,45,482,10.7,2,37.1,58,528,9.1,2,,kyle-williams-8
780,Layne Hatcher*,Arkansas State,Sun Belt,10,79,46,0.6,1,4.6,0,0,,0,0.0,79,46,0.6,1,,layne-hatcher-1
781,Austin Parker,Duke,ACC,12,3,45,15.0,0,3.8,0,0,,0,0.0,3,45,15.0,0,,austin-parker-2
782,Lawrence Keys III*,Notre Dame,Ind,12,6,45,7.5,0,3.8,13,134,10.3,0,11.2,19,179,9.4,0,,lawrence-keys-lll-1
783,Mike Epstein*,Illinois,Big Ten,1,8,45,5.6,0,45.0,0,0,,0,0.0,8,45,5.6,0,,mike-epstein-2
784,Tristan Gebbia,Oregon State,Pac-12,4,11,45,4.1,1,11.3,0,0,,0,0.0,11,45,4.1,1,,tristan-gebbia-1
785,Will Dabbs,North Carolina State,ACC,12,11,45,4.1,0,3.8,0,0,,0,0.0,11,45,4.1,0,,will-dabbs-1
786,Davis Mills,Stanford,Pac-12,8,32,44,1.4,0,5.5,1,8,8.0,1,1.0,33,52,1.6,1,,davis-mills-1
787,Matthew Murla*,Air Force,MWC,9,10,44,4.4,0,4.9,0,0,,0,0.0,10,44,4.4,0,,matthew-murla-1
788,Nick Eury*,Penn State,Big Ten,1,6,44,7.3,1,44.0,0,0,,0,0.0,6,44,7.3,1,,nick-eury-1
789,N'Kosi Perry*,Miami (FL),ACC,9,38,44,1.2,2,4.9,0,0,,0,0.0,38,44,1.2,2,,nkosi-perry-1
790,Reynaldo Flores,UTEP,CUSA,11,11,44,4.0,0,4.0,5,63,12.6,0,5.7,16,107,6.7,0,,reynaldo-flores-1
791,Tanner Blatt,Troy,Sun Belt,3,11,44,4.0,0,14.7,0,0,,0,0.0,11,44,4.0,0,,tanner-blatt-1
792,Terry Wilson*,Kentucky,SEC,4,17,44,2.6,1,11.0,1,32,32.0,0,8.0,18,76,4.2,1,,terry-wilson-3
793,Treshaun Ward*,Florida State,ACC,3,10,44,4.4,0,14.7,0,0,,0,0.0,10,44,4.4,0,,treshaun-ward-1
794,Zane Knipe,Rice,CUSA,4,4,44,11.0,0,11.0,1,42,42.0,0,10.5,5,86,17.2,0,,zane-knipe-1
795,Craig Elmore*,Kent State,MAC,10,12,43,3.6,1,4.3,0,0,,0,0.0,12,43,3.6,1,,craig-elmore-1
796,Decavilon Reese,Akron,MAC,2,10,43,4.3,0,21.5,1,4,4.0,0,2.0,11,47,4.3,0,,decavilon-reese-1
797,Dee Baker*,Southern Mississippi,CUSA,3,11,43,3.9,0,14.3,0,0,,0,0.0,11,43,3.9,0,,dee-baker-1
798,Demari Simpkins*,Utah,Pac-12,14,8,43,5.4,1,3.1,32,352,11.0,2,25.1,40,395,9.9,3,,demari-simpkins-1
799,Garrett Winn*,Navy,American,13,5,43,8.6,0,3.3,0,0,,0,0.0,5,43,8.6,0,,garrett-winn-1
800,Justice Shelton-Mosley,Vanderbilt,SEC,11,5,43,8.6,0,3.9,14,97,6.9,0,8.8,19,140,7.4,0,,justice-shelton-mosley-1
801,Kared Class,Coastal Carolina,Sun Belt,6,5,43,8.6,0,7.2,0,0,,0,0.0,5,43,8.6,0,,kared-class-1
802,KJ Hamler*,Penn State,Big Ten,13,13,43,3.3,0,3.3,56,904,16.1,8,69.5,69,947,13.7,8,,kj-hamler-1
803,Lucas Johnson,Georgia Tech,ACC,5,22,43,2.0,0,8.6,0,0,,0,0.0,22,43,2.0,0,,lucas-johnson-2
804,Malik Braxton*,Washington,Pac-12,13,2,43,21.5,0,3.3,0,0,,0,0.0,2,43,21.5,0,,malik-braxton-1
805,Maurice Burkley*,Louisville,ACC,10,8,43,5.4,0,4.3,0,0,,0,0.0,8,43,5.4,0,,maurice-burkley-1
806,Nakendrick Clark*,Appalachian State,Sun Belt,9,11,43,3.9,0,4.8,0,0,,0,0.0,11,43,3.9,0,,nakendrick-clark-1
807,Rondarius Gregory,Northern Illinois,MAC,3,9,43,4.8,0,14.3,0,0,,0,0.0,9,43,4.8,0,,rondarius-gregory-1
808,Tavares Kelly*,Virginia,ACC,11,5,43,8.6,0,3.9,14,152,10.9,1,13.8,19,195,10.3,1,,tavares-kelly-1
809,Whop Philyor*,Indiana,Big Ten,12,10,43,4.3,0,3.6,70,1002,14.3,5,83.5,80,1045,13.1,5,,whop-philyor-1
810,Jalen Virgil*,Appalachian State,Sun Belt,14,10,42,4.2,1,3.0,24,383,16.0,4,27.4,34,425,12.5,5,,jalen-virgil-1
811,Ja'Veon Marlow,Vanderbilt,SEC,8,10,42,4.2,0,5.3,0,0,,0,0.0,10,42,4.2,0,,javeon-marlow-1
812,Jaylen Coleman,Duke,ACC,9,15,42,2.8,0,4.7,0,0,,0,0.0,15,42,2.8,0,,jaylen-coleman-2
813,Jemel Jones,Army,Ind,2,12,42,3.5,1,21.0,0,0,,0,0.0,12,42,3.5,1,,jemel-jones-1
814,Joe Reed*,Virginia,ACC,13,8,42,5.3,0,3.2,77,679,8.8,7,52.2,85,721,8.5,7,,joe-reed-4
815,Keylon Stokes,Tulsa,American,12,9,42,4.7,0,3.5,62,1040,16.8,6,86.7,71,1082,15.2,6,,keylon-stokes-1
816,Malik Miller*,Auburn,SEC,10,12,42,3.5,0,4.2,4,49,12.3,0,4.9,16,91,5.7,0,,malik-miller-2
817,Maurice Alexander*,Florida International,CUSA,10,9,42,4.7,0,4.2,25,298,11.9,1,29.8,34,340,10.0,1,,maurice-alexander-2
818,Oscar Adaway III,North Texas,CUSA,3,4,42,10.5,0,14.0,0,0,,0,0.0,4,42,10.5,0,,oscar-adaway-iii-1
819,Tony Brown,South Alabama,Sun Belt,11,7,42,6.0,0,3.8,0,0,,0,0.0,7,42,6.0,0,,tony-brown-11
820,Alec Sinkfield,West Virginia,Big 12,12,17,41,2.4,0,3.4,5,18,3.6,0,1.5,22,59,2.7,0,,alec-sinkfield-1
821,Deion Hankins,UTEP,CUSA,4,9,41,4.6,0,10.3,0,0,,0,0.0,9,41,4.6,0,,deion-hankins-1
822,James Blackman*,Florida State,ACC,12,68,41,0.6,1,3.4,1,2,2.0,0,0.2,69,43,0.6,1,,james-blackman-1
823,Jeff Thomas*,Miami (FL),ACC,10,7,41,5.9,0,4.1,31,379,12.2,3,37.9,38,420,11.1,3,,jeff-thomas-6
824,Josh Adkins,New Mexico State,Ind,12,106,41,0.4,4,3.4,2,6,3.0,1,0.5,108,47,0.4,5,,josh-adkins-1
825,Myles Brennan*,LSU,SEC,10,9,41,4.6,0,4.1,0,0,,0,0.0,9,41,4.6,0,,myles-brennan-1
826,Theo Anderson*,Buffalo,MAC,10,9,41,4.6,0,4.1,0,0,,0,0.0,9,41,4.6,0,,theo-anderson-1
827,Cameron Sample*,Tulane,American,13,8,40,5.0,0,3.1,0,0,,0,0.0,8,40,5.0,0,,cameron-sample-1
828,Jordan Nathan*,Utah State,MWC,13,7,40,5.7,1,3.1,56,581,10.4,1,44.7,63,621,9.9,2,,jordan-nathan-1
829,Chase Hayden,Arkansas,SEC,4,12,39,3.3,0,9.8,4,12,3.0,0,3.0,16,51,3.2,0,,chase-hayden-1
830,Derek Green*,SMU,American,3,3,39,13.0,0,13.0,0,0,,0,0.0,3,39,13.0,0,,derek-green-2
831,Matt Geiger,Old Dominion,CUSA,9,12,39,3.3,0,4.3,3,46,15.3,1,5.1,15,85,5.7,1,,matt-geiger-1
832,Tyrone Tracy Jr.*,Iowa,Big Ten,13,6,39,6.5,1,3.0,36,589,16.4,3,45.3,42,628,15.0,4,,tyrone-tracy-jr-1
833,Isaiah Holiness,San Jose State,MWC,10,11,38,3.5,0,3.8,15,145,9.7,1,14.5,26,183,7.0,1,,isaiah-holiness-1
834,John Tank Miller,South Alabama,Sun Belt,5,12,38,3.2,0,7.6,2,22,11.0,0,4.4,14,60,4.3,0,,john-tank-miller-1
835,Malik Murray*,Georgia Southern,Sun Belt,13,7,38,5.4,0,2.9,20,195,9.8,3,15.0,27,233,8.6,3,,malik-murray-1
836,Quincy Jountti*,USC,Pac-12,13,13,38,2.9,0,2.9,0,0,,0,0.0,13,38,2.9,0,,quincy-jountti-1
837,Raghib Ismail Jr.*,Wyoming,MWC,12,6,38,6.3,1,3.2,23,355,15.4,2,29.6,29,393,13.6,3,,raghib-ismail-jr-1
838,Tylan Knight,Ole Miss,SEC,12,7,38,5.4,0,3.2,6,33,5.5,0,2.8,13,71,5.5,0,,tylan-knight-1
839,Tyler Lavine*,SMU,American,13,9,38,4.2,1,2.9,1,1,1.0,0,0.1,10,39,3.9,1,,tyler-lavine-1
840,Jermaine Johnson Jr.,Massachusetts,Ind,12,4,37,9.3,0,3.1,37,272,7.4,2,22.7,41,309,7.5,2,,jermaine-johnson-jr-1
841,Khaleb Hood*,Georgia Southern,Sun Belt,13,3,37,12.3,0,2.8,8,98,12.3,0,7.5,11,135,12.3,0,,khaleb-hood-1
842,McLane Mannix,Texas Tech,Big 12,12,3,37,12.3,0,3.1,26,248,9.5,3,20.7,29,285,9.8,3,,mclane-mannix-1
843,Simi Bakare,Missouri,SEC,12,8,37,4.6,0,3.1,0,0,,0,0.0,8,37,4.6,0,,simi-bakare-1
844,Terrance Gipson*,SMU,American,2,7,37,5.3,0,18.5,0,0,,0,0.0,7,37,5.3,0,,terrance-gipson-1
845,Anthony Adkins,Army,Ind,2,9,36,4.0,1,18.0,0,0,,0,0.0,9,36,4.0,1,,anthony-adkins-1
846,Cedric Byrd*,Hawaii,MWC,15,4,36,9.0,0,2.4,98,1097,11.2,10,73.1,102,1133,11.1,10,,cedric-byrd-1
847,Chris Lovick,Tulsa,American,3,9,36,4.0,0,12.0,0,0,,0,0.0,9,36,4.0,0,,chris-lovick-1
848,Justin Smith*,Navy,American,7,4,36,9.0,0,5.1,0,0,,0,0.0,4,36,9.0,0,,justin-smith-9
849,Kaylon Geiger,Troy,Sun Belt,12,4,36,9.0,1,3.0,77,873,11.3,5,72.8,81,909,11.2,6,,kaylon-geiger-1
850,Lanard Fournette*,LSU,SEC,4,13,36,2.8,1,9.0,5,19,3.8,0,4.8,18,55,3.1,1,,lanard-fournette-1
851,Mac Jones*,Alabama,SEC,12,16,36,2.3,1,3.0,1,-1,-1.0,0,-0.1,17,35,2.1,1,,mac-jones-1
852,Tee Higgins*,Clemson,ACC,15,1,36,36.0,1,2.4,59,1167,19.8,13,77.8,60,1203,20.1,14,,tee-higgins-1
853,Tyreek King-El*,Navy,American,7,6,36,6.0,1,5.1,0,0,,0,0.0,6,36,6.0,1,,tyreek-king-el-1
854,Ulysses Bentley IV*,SMU,American,4,7,36,5.1,0,9.0,1,30,30.0,0,7.5,8,66,8.3,0,,ulysses-bentley-iv-1
855,Abram Smith*,Baylor,Big 12,14,8,35,4.4,1,2.5,0,0,,0,0.0,8,35,4.4,1,,abram-smith-1
856,Andre Baccellia*,Washington,Pac-12,12,4,35,8.8,1,2.9,29,314,10.8,4,26.2,33,349,10.6,5,,andre-baccellia-1
857,Ben Bryant*,Cincinnati,American,7,22,35,1.6,1,5.0,0,0,,0,0.0,22,35,1.6,1,,ben-bryant-1
858,Christian Hayes,Army,Ind,8,1,35,35.0,0,4.4,1,17,17.0,0,2.1,2,52,26.0,0,,christian-hayes-1
859,Cord Sandberg*,Auburn,SEC,2,7,35,5.0,0,17.5,0,0,,0,0.0,7,35,5.0,0,,cord-sandberg-1
860,David Small,South Florida,American,7,5,35,7.0,1,5.0,0,0,,0,0.0,5,35,7.0,1,,david-small-2
861,Jackson Williamson*,Miami (OH),MAC,6,12,35,2.9,0,5.8,0,0,,0,0.0,12,35,2.9,0,,jackson-williamson-1
862,Kamari Pleasant*,Washington,Pac-12,11,16,35,2.2,0,3.2,2,26,13.0,0,2.4,18,61,3.4,0,,kamari-pleasant-1
863,Messiah deWeaver,Old Dominion,CUSA,5,47,35,0.7,0,7.0,1,16,16.0,0,3.2,48,51,1.1,0,,messiah-deweaver-1
864,Ra'Sean Davie*,Western Michigan,MAC,3,9,35,3.9,0,11.7,0,0,,0,0.0,9,35,3.9,0,,rasean-davie-1
865,Sam Howell*,North Carolina,ACC,13,94,35,0.4,1,2.7,3,23,7.7,1,1.8,97,58,0.6,2,,sam-howell-1
866,Tom Stewart,Rice,CUSA,10,53,35,0.7,2,3.5,0,0,,0,0.0,53,35,0.7,2,,tom-stewart-1
867,Treylon Burks,Arkansas,SEC,11,9,35,3.9,0,3.2,29,475,16.4,0,43.2,38,510,13.4,0,,treylon-burks-1
868,Tyrice Richie,Northern Illinois,MAC,11,5,35,7.0,0,3.2,32,415,13.0,4,37.7,37,450,12.2,4,,tyrice-richie-1
869,A.J. Taylor*,Wisconsin,Big Ten,12,6,34,5.7,0,2.8,23,267,11.6,2,22.3,29,301,10.4,2,,aj-taylor-1
870,Cam Sutton,Fresno State,MWC,12,2,34,17.0,0,2.8,6,112,18.7,0,9.3,8,146,18.3,0,,cam-sutton-1
871,Jahmyl Jeter*,Oklahoma State,Big 12,3,11,34,3.1,0,11.3,0,0,,0,0.0,11,34,3.1,0,,jahmyl-jeter-1
872,Lawrence Papillon*,Marshall,CUSA,9,6,34,5.7,0,3.8,0,0,,0,0.0,6,34,5.7,0,,lawrence-papillon-1
873,Martell Irby,UCLA,Pac-12,8,10,34,3.4,0,4.3,5,48,9.6,0,6.0,15,82,5.5,0,,martell-irby-1
874,Mick Assaf*,Notre Dame,Ind,12,9,34,3.8,0,2.8,0,0,,0,0.0,9,34,3.8,0,,mick-assaf-1
875,Mo Hasan,Vanderbilt,SEC,2,9,34,3.8,0,17.0,0,0,,0,0.0,9,34,3.8,0,,mo-hasan-1
876,Ryan Willis*,Virginia Tech,ACC,5,39,34,0.9,1,6.8,0,0,,0,0.0,39,34,0.9,1,,ryan-willis-2
877,Brendon Clark*,Notre Dame,Ind,3,5,33,6.6,0,11.0,0,0,,0,0.0,5,33,6.6,0,,brendon-clark-1
878,Cole Kinder,UCLA,Pac-12,6,4,33,8.3,0,5.5,0,0,,0,0.0,4,33,8.3,0,,cole-kinder-1
879,Dalton Keene*,Virginia Tech,ACC,13,11,33,3.0,0,2.5,21,240,11.4,5,18.5,32,273,8.5,5,,dalton-keene-1
880,Evan Shirreffs*,Charlotte,CUSA,2,3,33,11.0,0,16.5,0,0,,0,0.0,3,33,11.0,0,,evan-shirreffs-1
881,Tony Brown,Colorado,Pac-12,12,6,33,5.5,1,2.8,56,707,12.6,5,58.9,62,740,11.9,6,,tony-brown-9
882,Brody Belt,Nebraska,Big Ten,12,5,32,6.4,0,2.7,0,0,,0,0.0,5,32,6.4,0,,brody-belt-1
883,Cam Wiley*,Minnesota,Big Ten,3,11,32,2.9,0,10.7,1,0,0.0,0,0.0,12,32,2.7,0,,cam-wiley-1
884,Christian Malloy,Georgia Tech,ACC,4,7,32,4.6,0,8.0,0,0,,0,0.0,7,32,4.6,0,,christian-malloy-1
885,Dawson Schick*,Western Michigan,MAC,10,8,32,4.0,0,3.2,0,0,,0,0.0,8,32,4.0,0,,dawson-schick-1
886,Ethan Long*,Arizona State,Pac-12,10,6,32,5.3,0,3.2,0,0,,0,0.0,6,32,5.3,0,,ethan-long-1
887,Fred Orr*,Tennessee,SEC,3,7,32,4.6,0,10.7,0,0,,0,0.0,7,32,4.6,0,,fred-orr-1
888,Isaiah Hamilton,San Jose State,MWC,12,7,32,4.6,0,2.7,43,718,16.7,4,59.8,50,750,15.0,4,,isaiah-hamilton-2
889,Kavika Johnson,UTEP,CUSA,10,3,32,10.7,0,3.2,11,79,7.2,0,7.9,14,111,7.9,0,,kavika-johnson-1
890,Nigel Sealey,Bowling Green,MAC,8,16,32,2.0,0,4.0,1,-3,-3.0,0,-0.4,17,29,1.7,0,,nigel-sealey-1
891,Quartney Davis*,Texas A&M,SEC,11,5,32,6.4,0,2.9,54,616,11.4,4,56.0,59,648,11.0,4,,quartney-davis-1
892,Rashaad Bolton,Army,Ind,5,10,32,3.2,1,6.4,0,0,,0,0.0,10,32,3.2,1,,rashaad-bolton-1
893,Shaun Peterson Jr.*,Florida International,CUSA,3,8,32,4.0,0,10.7,0,0,,0,0.0,8,32,4.0,0,,shaun-peterson-jr-1
894,Shaun Peterson Jr.*,Florida International,CUSA,12,8,32,4.0,0,2.7,0,0,,0,0.0,8,32,4.0,0,,shaun-peterson-jr-2
895,Tario Fuller,Purdue,Big Ten,4,12,32,2.7,0,8.0,0,0,,0,0.0,12,32,2.7,0,,tario-fuller-1
896,Terrick Smalls Jr.*,Charlotte,CUSA,4,7,32,4.6,0,8.0,0,0,,0,0.0,7,32,4.6,0,,terrick-smalls-jr-1
897,Anthony McAfee,Coastal Carolina,Sun Belt,12,3,31,10.3,1,2.6,0,0,,0,0.0,3,31,10.3,1,,anthony-mcafee-1
898,Danny Smith*,Boise State,MWC,3,8,31,3.9,0,10.3,0,0,,0,0.0,8,31,3.9,0,,danny-smith-5
899,Demetrious Flowers*,Arizona State,Pac-12,2,11,31,2.8,0,15.5,0,0,,0,0.0,11,31,2.8,0,,demetrious-flowers-1
900,Henry Colombi*,Utah State,MWC,6,14,31,2.2,1,5.2,0,0,,0,0.0,14,31,2.2,1,,henry-colombi-1
901,Isaiah Woullard,Ole Miss,SEC,12,10,31,3.1,0,2.6,0,0,,0,0.0,10,31,3.1,0,,isaiah-woullard-1
902,Jason Shelley*,Utah,Pac-12,10,19,31,1.6,1,3.1,0,0,,0,0.0,19,31,1.6,1,,jason-shelley-2
903,JD Spielman,Nebraska,Big Ten,12,4,31,7.8,0,2.6,49,898,18.3,5,74.8,53,929,17.5,5,,jd-spielman-1
904,Merek Pierce*,SMU,American,5,10,31,3.1,1,6.2,0,0,,0,0.0,10,31,3.1,1,,merek-pierce-1
905,Cameron Montgomery,Rice,CUSA,7,9,30,3.3,0,4.3,2,8,4.0,0,1.1,11,38,3.5,0,,cameron-montgomery-1
906,Connor Wedington,Stanford,Pac-12,11,3,30,10.0,0,2.7,51,506,9.9,1,46.0,54,536,9.9,1,,connor-wedington-1
907,Dee Wiggins*,Miami (FL),ACC,12,3,30,10.0,0,2.5,20,335,16.8,4,27.9,23,365,15.9,4,,dee-wiggins-1
908,Jashawn Sheffield*,Auburn,SEC,1,2,30,15.0,0,30.0,0,0,,0,0.0,2,30,15.0,0,,jashawn-sheffield-1
909,Ja'shawn Sheffield*,Auburn,SEC,1,2,30,15.0,0,30.0,0,0,,0,0.0,2,30,15.0,0,,jashawn-sheffield-2
910,Kelan Walker,Houston,American,11,7,30,4.3,0,2.7,1,4,4.0,0,0.4,8,34,4.3,0,,kelan-walker-1
911,Timothy Taylor*,Memphis,American,5,11,30,2.7,0,6.0,2,13,6.5,0,2.6,13,43,3.3,0,,timothy-taylor-1
912,Chatarius Atwell*,Louisville,ACC,13,8,29,3.6,0,2.2,70,1276,18.2,12,98.2,78,1305,16.7,12,,chatarius-atwell-1
913,Elijah Hines*,Louisiana Tech,CUSA,1,3,29,9.7,0,29.0,0,0,,0,0.0,3,29,9.7,0,,elijah-hines-1
914,Elijah Sindelar,Purdue,Big Ten,5,12,29,2.4,1,5.8,0,0,,0,0.0,12,29,2.4,1,,elijah-sindelar-1
915,John Moten IV,Northwestern,Big Ten,6,14,29,2.1,1,4.8,5,37,7.4,0,6.2,19,66,3.5,1,,john-moten-iv-1
916,Kirk Rygol,South Florida,American,5,9,29,3.2,0,5.8,0,0,,0,0.0,9,29,3.2,0,,kirk-rygol-1
917,Naveon Mitchell,New Mexico State,Ind,8,7,29,4.1,0,3.6,18,274,15.2,1,34.3,25,303,12.1,1,,naveon-mitchell-1
918,AJ Howard Jr.,Army,Ind,6,2,28,14.0,0,4.7,0,0,,0,0.0,2,28,14.0,0,,aj-howard-jr-1
919,Calvin Hill,Texas State,Sun Belt,5,16,28,1.8,1,5.6,6,69,11.5,0,13.8,22,97,4.4,1,,calvin-hill-4
920,Connor Blumrick*,Texas A&M,SEC,9,7,28,4.0,0,3.1,0,0,,0,0.0,7,28,4.0,0,,connor-blumrick-1
921,Jacob Copeland*,Florida,SEC,13,4,28,7.0,0,2.2,21,273,13.0,2,21.0,25,301,12.0,2,,jacob-copeland-1
922,Jax Welch,Texas Tech,Big 12,12,5,28,5.6,0,2.3,1,10,10.0,0,0.8,6,38,6.3,0,,jax-welch-1
923,Marcus Major*,Oklahoma,Big 12,3,10,28,2.8,0,9.3,0,0,,0,0.0,10,28,2.8,0,,marcus-major-1
924,Mychal Cooper*,Navy,American,12,3,28,9.3,0,2.3,18,380,21.1,2,31.7,21,408,19.4,2,,mychal-cooper-1
925,Austin Conway*,Wyoming,MWC,13,6,27,4.5,0,2.1,23,314,13.7,1,24.2,29,341,11.8,1,,austin-conway-1
926,Ben Glines*,Boston College,ACC,12,6,27,4.5,0,2.3,10,97,9.7,0,8.1,16,124,7.8,0,,ben-glines-1
927,Blake Stenstrom,Colorado,Pac-12,3,1,27,27.0,0,9.0,0,0,,0,0.0,1,27,27.0,0,,blake-stenstrom-1
928,Cameron Ross,Connecticut,American,11,3,27,9.0,0,2.5,60,723,12.1,4,65.7,63,750,11.9,4,,cameron-ross-1
929,Eli Peters,Toledo,MAC,5,16,27,1.7,0,5.4,0,0,,0,0.0,16,27,1.7,0,,eli-peters-1
930,Freddie Swain*,Florida,SEC,12,4,27,6.8,0,2.3,38,517,13.6,7,43.1,42,544,13.0,7,,freddie-swain-1
931,Jalen Nailor*,Michigan State,Big Ten,4,5,27,5.4,0,6.8,15,106,7.1,0,26.5,20,133,6.7,0,,jalen-nailor-1
932,Josh Fleeks*,Baylor,Big 12,14,9,27,3.0,1,1.9,25,262,10.5,1,18.7,34,289,8.5,2,,josh-fleeks-1
933,Kelvin Dean Jr.*,Florida Atlantic,CUSA,6,8,27,3.4,0,4.5,0,0,,0,0.0,8,27,3.4,0,,kelvin-dean-jr-1
934,Kendrell Flowers*,Wake Forest,ACC,1,9,27,3.0,0,27.0,0,0,,0,0.0,9,27,3.0,0,,kendrell-flowers-1
935,Kendrell Flowers*,Wake Forest,ACC,2,9,27,3.0,0,13.5,0,0,,0,0.0,9,27,3.0,0,,kendrell-flowers-2
936,Nick Patti*,Pitt,ACC,6,5,27,5.4,0,4.5,0,0,,0,0.0,5,27,5.4,0,,nick-patti-3
937,Tyler Snead,East Carolina,American,12,4,27,6.8,0,2.3,66,759,11.5,5,63.3,70,786,11.2,5,,tyler-snead-1
938,Connor Adair*,Memphis,American,5,2,26,13.0,1,5.2,0,0,,0,0.0,2,26,13.0,1,,connor-adair-1
939,Javohn Jones,New Mexico,MWC,4,8,26,3.3,0,6.5,3,13,4.3,0,3.3,11,39,3.5,0,,javohn-jones-1
940,Kyren Williams*,Notre Dame,Ind,4,4,26,6.5,0,6.5,1,3,3.0,0,0.8,5,29,5.8,0,,kyren-williams-1
941,Max Duffy*,Kentucky,SEC,13,1,26,26.0,0,2.0,0,0,,0,0.0,1,26,26.0,0,AA,max-duffy-1
942,Michael Kopaygorodsky*,Cincinnati,American,12,7,26,3.7,1,2.2,0,0,,0,0.0,7,26,3.7,1,,michael-kopaygorodsky-1
943,Mitchell Crawford,UTEP,CUSA,12,1,26,26.0,0,2.2,0,0,,0,0.0,1,26,26.0,0,,mitchell-crawford-1
944,Phillip Brooks*,Kansas State,Big 12,12,7,26,3.7,0,2.2,26,253,9.7,1,21.1,33,279,8.5,1,,phillip-brooks-1
945,Rahveon Valentine,Northern Illinois,MAC,8,6,26,4.3,0,3.3,1,3,3.0,0,0.4,7,29,4.1,0,,rahveon-valentine-1
946,Saevion Johnson,Fresno State,MWC,9,4,26,6.5,0,2.9,0,0,,0,0.0,4,26,6.5,0,,saevion-johnson-1
947,Trevon Clark*,California,Pac-12,13,2,26,13.0,0,2.0,21,250,11.9,2,19.2,23,276,12.0,2,,trevon-clark-1
948,Andrew Strader*,Boston College,ACC,12,4,25,6.3,0,2.1,0,0,,0,0.0,4,25,6.3,0,,andrew-strader-1
949,Brady Schipper*,Wisconsin,Big Ten,6,8,25,3.1,0,4.2,0,0,,0,0.0,8,25,3.1,0,,brady-schipper-1
950,Chad Alexander,New Mexico,MWC,4,5,25,5.0,0,6.3,0,0,,0,0.0,5,25,5.0,0,,chad-alexander-4
951,Clay Markoff*,Washington State,Pac-12,7,9,25,2.8,0,3.6,0,0,,0,0.0,9,25,2.8,0,,clay-markoff-1
952,James Harris II*,Navy,American,8,9,25,2.8,0,3.1,0,0,,0,0.0,9,25,2.8,0,,james-harris-ll-1
953,La'darius Jefferson*,Michigan State,Big Ten,6,19,25,1.3,2,4.2,3,34,11.3,0,5.7,22,59,2.7,2,,ladarius-jefferson-1
954,Rashad Medaris*,Cincinnati,American,14,2,25,12.5,0,1.8,25,354,14.2,2,25.3,27,379,14.0,2,,rashad-medaris-1
955,Steven Krajewski,Connecticut,American,4,13,25,1.9,1,6.3,0,0,,0,0.0,13,25,1.9,1,,steven-krajewski-1
956,Taj Harris,Syracuse,ACC,12,2,25,12.5,0,2.1,37,559,15.1,2,46.6,39,584,15.0,2,,taj-harris-1
957,TaMerik Williams*,SMU,American,6,10,25,2.5,0,4.2,1,5,5.0,0,0.8,11,30,2.7,0,,tamerik-williams-1
958,A'Montae Spivey,Arkansas,SEC,2,7,24,3.4,0,12.0,0,0,,0,0.0,7,24,3.4,0,,amontae-spivey-1
959,Bryce Williams*,Minnesota,Big Ten,2,17,24,1.4,1,12.0,1,10,10.0,0,5.0,18,34,1.9,1,,bryce-williams-4
960,Chip Omer*,Tennessee,SEC,2,2,24,12.0,0,12.0,0,0,,0,0.0,2,24,12.0,0,,chip-omer-1
961,Darius Maberry*,Southern Mississippi,CUSA,6,18,24,1.3,0,4.0,0,0,,0,0.0,18,24,1.3,0,,darius-maberry-1
962,Devin Duvernay*,Texas,Big 12,13,10,24,2.4,1,1.8,106,1386,13.1,9,106.6,116,1410,12.2,10,,devin-duvernay-1
963,Devin Gentry*,Georgia State,Sun Belt,13,3,24,8.0,0,1.8,25,286,11.4,2,22.0,28,310,11.1,2,,devin-gentry-1
964,K.J. Costello,Stanford,Pac-12,5,18,24,1.3,0,4.8,1,-12,-12.0,0,-2.4,19,12,0.6,0,,kj-costello-1
965,Michael Kern*,Wake Forest,ACC,2,5,24,4.8,0,12.0,0,0,,0,0.0,5,24,4.8,0,,michael-kern-1
966,Nay'quan Wright*,Florida,SEC,3,12,24,2.0,0,8.0,1,4,4.0,0,1.3,13,28,2.2,0,,nayquan-wright-1
967,Sean Ryan,West Virginia,Big 12,8,1,24,24.0,0,3.0,19,219,11.5,0,27.4,20,243,12.2,0,,sean-ryan-2
968,Tahj Gary*,Virginia Tech,ACC,1,4,24,6.0,0,24.0,0,0,,0,0.0,4,24,6.0,0,,tahj-gary-1
969,Trevon Bradford,Oregon State,Pac-12,4,2,24,12.0,0,6.0,13,121,9.3,1,30.3,15,145,9.7,1,,trevon-bradford-1
970,Baden Pinson,Coastal Carolina,Sun Belt,8,10,23,2.3,0,2.9,0,0,,0,0.0,10,23,2.3,0,,baden-pinson-1
971,Camerun Peoples*,Appalachian State,Sun Belt,1,3,23,7.7,0,23.0,0,0,,0,0.0,3,23,7.7,0,,camerun-peoples-1
972,Christian Daniels*,Tulane,American,2,3,23,7.7,0,11.5,0,0,,0,0.0,3,23,7.7,0,,christian-daniels-1
973,Dylan Drummond*,Eastern Michigan,MAC,13,4,23,5.8,0,1.8,55,493,9.0,3,37.9,59,516,8.7,3,,dylan-drummond-1
974,Ivory Kelly-Martin*,Iowa,Big Ten,4,6,23,3.8,0,5.8,2,25,12.5,0,6.3,8,48,6.0,0,,ivory-kelly-martin-1
975,Jaylin Nelson,Texas State,Sun Belt,10,5,23,4.6,0,2.3,1,4,4.0,0,0.4,6,27,4.5,0,,jaylin-nelson-1
976,Mark Pope*,Miami (FL),ACC,12,3,23,7.7,0,1.9,18,266,14.8,2,22.2,21,289,13.8,2,,mark-pope-1
977,Spencer Rattler*,Oklahoma,Big 12,3,3,23,7.7,0,7.7,0,0,,0,0.0,3,23,7.7,0,,spencer-rattler-1
978,Spencer Shrader,South Florida,American,12,2,23,11.5,1,1.9,0,0,,0,0.0,2,23,11.5,1,,spencer-shrader-1
979,Alex Thomson*,Marshall,CUSA,3,7,22,3.1,0,7.3,0,0,,0,0.0,7,22,3.1,0,,alex-thomson-1
980,Bo Melton,Rutgers,Big Ten,12,4,22,5.5,0,1.8,30,427,14.2,2,35.6,34,449,13.2,2,,bo-melton-1
981,Brian Casteel,Arizona,Pac-12,12,4,22,5.5,0,1.8,45,397,8.8,3,33.1,49,419,8.6,3,,brian-casteel-1
982,Britain Covey*,Utah,Pac-12,4,3,22,7.3,0,5.5,10,77,7.7,0,19.3,13,99,7.6,0,,britain-covey-1
983,Bryan Edwards,South Carolina,SEC,10,2,22,11.0,0,2.2,71,816,11.5,6,81.6,73,838,11.5,6,,bryan-edwards-1
984,Casey Thompson*,Texas,Big 12,5,10,22,2.2,1,4.4,0,0,,0,0.0,10,22,2.2,1,,casey-thompson-1
985,Chadarius Townsend*,Alabama,SEC,6,8,22,2.8,0,3.7,0,0,,0,0.0,8,22,2.8,0,,chadarius-townsend-1
986,Cody White*,Michigan State,Big Ten,13,6,22,3.7,0,1.7,66,922,14.0,6,70.9,72,944,13.1,6,,cody-white-3
987,CT Thomas*,Boise State,MWC,14,2,22,11.0,1,1.6,41,522,12.7,5,37.3,43,544,12.7,6,,ct-thomas-1
988,Drew Dan,New Mexico State,Ind,3,2,22,11.0,0,7.3,5,49,9.8,0,16.3,7,71,10.1,0,,drew-dan-1
989,Jace Ruder*,North Carolina,ACC,2,4,22,5.5,0,11.0,0,0,,0,0.0,4,22,5.5,0,,jace-ruder-1
990,Jack Coan*,Wisconsin,Big Ten,14,56,22,0.4,4,1.6,0,0,,0,0.0,56,22,0.4,4,,jack-coan-1
991,John Stephen Jones,Arkansas,SEC,3,11,22,2.0,0,7.3,0,0,,0,0.0,11,22,2.0,0,,john-stephen-jones-1
992,Manny Miles,Kansas,Big 12,5,7,22,3.1,1,4.4,0,0,,0,0.0,7,22,3.1,1,,manny-miles-1
993,Maurice Ffrench*,Pitt,ACC,11,9,22,2.4,0,2.0,96,850,8.9,4,77.3,105,872,8.3,4,,maurice-ffrench-1
994,Michael Orphey Jr.*,Louisiana,Sun Belt,2,3,22,7.3,1,11.0,0,0,,0,0.0,3,22,7.3,1,,michael-orphey-jr-1
995,Mike Harley*,Miami (FL),ACC,13,4,22,5.5,0,1.7,38,485,12.8,3,37.3,42,507,12.1,3,,mike-harley-1
996,Prestron Jelen*,Minnesota,Big Ten,1,3,22,7.3,0,22.0,0,0,,0,0.0,3,22,7.3,0,,prestron-jelen-1
997,Terrell Brown,Houston,American,3,10,22,2.2,0,7.3,1,6,6.0,0,2.0,11,28,2.5,0,,terrell-brown-3
998,Tyree Jackson,Nevada-Las Vegas,MWC,12,6,22,3.7,0,1.8,2,-1,-0.5,0,-0.1,8,21,2.6,0,,tyree-jackson-3
999,Tyrick Tisdale*,Florida Atlantic,CUSA,13,6,22,3.7,0,1.7,0,0,,0,0.0,6,22,3.7,0,,tyrick-tisdale-1
1000,Walker Wood*,Kentucky,SEC,2,3,22,7.3,0,11.0,0,0,,0,0.0,3,22,7.3,0,,walker-wood-2
1001,Frank Boyd*,Liberty,Ind,2,4,21,5.3,0,10.5,0,0,,0,0.0,4,21,5.3,0,,frank-boyd-1
1002,Louis Hedley*,Miami (FL),ACC,13,1,21,21.0,0,1.6,0,0,,0,0.0,1,21,21.0,0,,louis-hedley-1
1003,Marquavius Weaver*,Memphis,American,8,5,21,4.2,0,2.6,0,0,,0,0.0,5,21,4.2,0,,marquavius-weaver-1
1004,Micaleous Elder*,Charlotte,CUSA,10,4,21,5.3,0,2.1,21,266,12.7,1,26.6,25,287,11.5,1,,micaleous-elder-1
1005,Tre'shon Wolf,UTEP,CUSA,12,3,21,7.0,0,1.8,34,433,12.7,2,36.1,37,454,12.3,2,,treshon-wolf-1
1006,Ben Batson*,Clemson,ACC,10,4,20,5.0,0,2.0,0,0,,0,0.0,4,20,5.0,0,,ben-batson-1
1007,Ben VanSumeren*,Michigan,Big Ten,5,9,20,2.2,1,4.0,0,0,,0,0.0,9,20,2.2,1,,ben-vansumeren-1
1008,CeeDee Lamb*,Oklahoma,Big 12,13,9,20,2.2,1,1.5,62,1327,21.4,14,102.1,71,1347,19.0,15,AA,ceedee-lamb-1
1009,Eli Pancol,Duke,ACC,12,3,20,6.7,1,1.7,6,91,15.2,3,7.6,9,111,12.3,4,,eli-pancol-1
1010,Evan Johnson,North Texas,CUSA,11,5,20,4.0,0,1.8,0,0,,0,0.0,5,20,4.0,0,,evan-johnson-1
1011,Jack Tuttle*,Indiana,Big Ten,5,9,20,2.2,0,4.0,0,0,,0,0.0,9,20,2.2,0,,jack-tuttle-1
1012,Jadan Blue*,Temple,American,13,6,20,3.3,0,1.5,95,1067,11.2,4,82.1,101,1087,10.8,4,,jadan-blue-1
1013,Kurtis Rourke*,Ohio,MAC,1,3,20,6.7,0,20.0,0,0,,0,0.0,3,20,6.7,0,,kurtis-rourke-1
1014,Travis Brannan*,Navy,American,12,1,20,20.0,0,1.7,0,0,,0,0.0,1,20,20.0,0,,travis-brannan-1
1015,Tylan Morton,South Alabama,Sun Belt,4,15,20,1.3,1,5.0,0,0,,0,0.0,15,20,1.3,1,,tylan-morton-1
1016,Tyriq Thompson*,Michigan State,Big Ten,13,1,20,20.0,0,1.5,0,0,,0,0.0,1,20,20.0,0,,tyriq-thompson-1
1017,Ahrod Lloyd*,Indiana,Big Ten,13,10,19,1.9,0,1.5,0,0,,0,0.0,10,19,1.9,0,,ahrod-lloyd-1
1018,Anthony Watkins,Missouri,SEC,1,6,19,3.2,0,19.0,0,0,,0,0.0,6,19,3.2,0,,anthony-watkins-3
1019,Brennan Armstrong*,Virginia,ACC,7,7,19,2.7,0,2.7,0,0,,0,0.0,7,19,2.7,0,,brennan-armstrong-1
1020,Chris Platt*,Baylor,Big 12,14,4,19,4.8,1,1.4,24,353,14.7,1,25.2,28,372,13.3,2,,chris-platt-1
1021,Colton Parton*,Air Force,MWC,1,2,19,9.5,0,19.0,0,0,,0,0.0,2,19,9.5,0,,colton-parton-1
1022,Courtney McKinney*,Wake Forest,ACC,4,6,19,3.2,0,4.8,0,0,,0,0.0,6,19,3.2,0,,courtney-mckinney-1
1023,Devin Maddox,Toledo,MAC,12,1,19,19.0,0,1.6,14,130,9.3,3,10.8,15,149,9.9,3,,devin-maddox-1
1024,Jalen Holston*,Virginia Tech,ACC,1,6,19,3.2,0,19.0,0,0,,0,0.0,6,19,3.2,0,,jalen-holston-1
1025,Julian Barnett*,Michigan State,Big Ten,13,2,19,9.5,0,1.5,13,182,14.0,0,14.0,15,201,13.4,0,,julian-barnett-1
1026,K.D. Nixon,Colorado,Pac-12,12,5,19,3.8,0,1.6,35,465,13.3,3,38.8,40,484,12.1,3,,kd-nixon-1
1027,Keyshawn Helton*,Florida State,ACC,6,2,19,9.5,0,3.2,17,239,14.1,3,39.8,19,258,13.6,3,,keyshawn-helton-1
1028,Kobay White*,Boston College,ACC,13,4,19,4.8,0,1.5,29,460,15.9,5,35.4,33,479,14.5,5,,kobay-white-1
1029,Line Latu*,Eastern Michigan,MAC,13,6,19,3.2,0,1.5,30,373,12.4,3,28.7,36,392,10.9,3,,line-latu-1
1030,Roger Neal*,Nevada,MWC,11,11,19,1.7,0,1.7,1,8,8.0,0,0.7,12,27,2.3,0,,roger-neal-1
1031,Sam James,West Virginia,Big 12,12,4,19,4.8,0,1.6,69,677,9.8,2,56.4,73,696,9.5,2,,sam-james-1
1032,Sevaughn Clark*,Georgia,SEC,2,6,19,3.2,0,9.5,0,0,,0,0.0,6,19,3.2,0,,sevaughn-clark-1
1033,Tate Whatley*,Southern Mississippi,CUSA,3,13,19,1.5,0,6.3,0,0,,0,0.0,13,19,1.5,0,,tate-whatley-1
1034,Champ Flemings,Oregon State,Pac-12,12,3,18,6.0,0,1.5,32,457,14.3,3,38.1,35,475,13.6,3,,champ-flemings-1
1035,Chase Brown*,Illinois,Big Ten,4,3,18,6.0,0,4.5,0,0,,0,0.0,3,18,6.0,0,,chase-brown-3
1036,Cody Grace*,Arkansas State,Sun Belt,13,1,18,18.0,0,1.4,0,0,,0,0.0,1,18,18.0,0,,cody-grace-1
1037,Derius Davis,TCU,Big 12,12,3,18,6.0,0,1.5,11,151,13.7,0,12.6,14,169,12.1,0,,derius-davis-1
1038,D.J. Matthews*,Florida State,ACC,12,4,18,4.5,0,1.5,36,355,9.9,3,29.6,40,373,9.3,3,,dj-matthews-1
1039,Dominico Monsion,Connecticut,American,1,3,18,6.0,0,18.0,0,0,,0,0.0,3,18,6.0,0,,dominico-monsion-1
1040,Elijah Deveaux,Duke,ACC,3,6,18,3.0,0,6.0,0,0,,0,0.0,6,18,3.0,0,,elijah-deveaux-1
1041,James Proche*,SMU,American,13,4,18,4.5,0,1.4,111,1225,11.0,15,94.2,115,1243,10.8,15,,james-proche-1
1042,Ja'Shaun Poke*,Kent State,MAC,11,1,18,18.0,0,1.6,3,30,10.0,0,2.7,4,48,12.0,0,,jashaun-poke-1
1043,Jimmy Murphy*,Miami (FL),ACC,13,5,18,3.6,1,1.4,0,0,,0,0.0,5,18,3.6,1,,jimmy-murphy-1
1044,Jordan Yates,Georgia Tech,ACC,3,11,18,1.6,0,6.0,0,0,,0,0.0,11,18,1.6,0,,jordan-yates-1
1045,Markevion Quinn*,Memphis,American,2,6,18,3.0,0,9.0,0,0,,0,0.0,6,18,3.0,0,,markevion-quinn-1
1046,Michael Bollinger*,Liberty,Ind,3,3,18,6.0,0,6.0,1,19,19.0,1,6.3,4,37,9.3,1,,michael-bollinger-1
1047,Mitchell Burton*,Miami (OH),MAC,4,7,18,2.6,0,4.5,0,0,,0,0.0,7,18,2.6,0,,mitchell-burton-1
1048,Victor Tucker*,Charlotte,CUSA,13,3,18,6.0,1,1.4,52,909,17.5,7,69.9,55,927,16.9,8,,victor-tucker-1
1049,Wayne Toussant*,Louisiana Tech,CUSA,13,2,18,9.0,0,1.4,2,26,13.0,0,2.0,4,44,11.0,0,,wayne-toussant-1
1050,Andrew David,Northwestern,Big Ten,7,1,17,17.0,0,2.4,0,0,,0,0.0,1,17,17.0,0,,andrew-david-1
1051,Damean Bivins,South Alabama,Sun Belt,3,3,17,5.7,0,5.7,0,0,,0,0.0,3,17,5.7,0,,damean-bivins-1
1052,Donevin O'Reilly,Connecticut,American,2,5,17,3.4,0,8.5,0,0,,0,0.0,5,17,3.4,0,,donevin-oreilly-2
1053,Griffin Alstott*,Western Michigan,MAC,4,3,17,5.7,0,4.3,0,0,,0,0.0,3,17,5.7,0,,griffin-alstott-1
1054,Jacquez Stuart,Toledo,MAC,4,4,17,4.3,0,4.3,4,42,10.5,0,10.5,8,59,7.4,0,,jacquez-stuart-1
1055,Joshua Samuel*,Western Kentucky,CUSA,4,6,17,2.8,0,4.3,2,10,5.0,0,2.5,8,27,3.4,0,,joshua-samuel-1
1056,Markice Hurt Jr.,Ball State,MAC,2,8,17,2.1,0,8.5,0,0,,0,0.0,8,17,2.1,0,,markice-hurt-jr-1
1057,Octavius Evans*,Boise State,MWC,14,1,17,17.0,1,1.2,19,211,11.1,1,15.1,20,228,11.4,2,,octavius-evans-1
1058,Quinton Conaway*,Nevada,MWC,13,1,17,17.0,0,1.3,0,0,,0,0.0,1,17,17.0,0,,quinton-conaway-1
1059,Tua Tagovailoa*,Alabama,SEC,9,23,17,0.7,2,1.9,0,0,,0,0.0,23,17,0.7,2,H-10,tua-tagovailoa-1
1060,Willie Wright*,Florida Atlantic,CUSA,11,4,17,4.3,0,1.5,20,186,9.3,2,16.9,24,203,8.5,2,,willie-wright-4
1061,Dalen Morris*,Navy,American,2,2,16,8.0,0,8.0,0,0,,0,0.0,2,16,8.0,0,,dalen-morris-1
1062,Dalen Morris*,Navy,American,2,2,16,8.0,0,8.0,0,0,,0,0.0,2,16,8.0,0,,dalen-morris-2
1063,Davis Shanley*,Western Kentucky,CUSA,1,1,16,16.0,0,16.0,0,0,,0,0.0,1,16,16.0,0,,davis-shanley-1
1064,Dax Milne*,BYU,Ind,13,4,16,4.0,0,1.2,21,285,13.6,2,21.9,25,301,12.0,2,,dax-milne-1
1065,Gabe Montgomery*,Appalachian State,Sun Belt,2,4,16,4.0,0,8.0,0,0,,0,0.0,4,16,4.0,0,,gabe-montgomery-1
1066,Gino Appleberry Jr.*,Western Kentucky,CUSA,2,5,16,3.2,0,8.0,0,0,,0,0.0,5,16,3.2,0,,gino-appleberry-jr-1
1067,Isaiah Williams*,Illinois,Big Ten,4,9,16,1.8,0,4.0,3,9,3.0,0,2.3,12,25,2.1,0,,isaiah-williams-7
1068,Jalen Moy,Army,Ind,7,1,16,16.0,1,2.3,0,0,,0,0.0,1,16,16.0,1,,jalen-moy-1
1069,Jaylond Adams*,Southern Mississippi,CUSA,9,7,16,2.3,0,1.8,48,483,10.1,2,53.7,55,499,9.1,2,,jaylond-adams-1
1070,Joe Milton*,Michigan,Big Ten,4,5,16,3.2,1,4.0,0,0,,0,0.0,5,16,3.2,1,,joe-milton-2
1071,Malik Williams*,Appalachian State,Sun Belt,14,5,16,3.2,0,1.1,55,598,10.9,4,42.7,60,614,10.2,4,,malik-williams-2
1072,Randall West,Massachusetts,Ind,8,21,16,0.8,2,2.0,0,0,,0,0.0,21,16,0.8,2,,randall-west-1
1073,Reagan Williams,Rice,CUSA,3,4,16,4.0,0,5.3,0,0,,0,0.0,4,16,4.0,0,,reagan-williams-1
1074,Tanner Mordecai*,Oklahoma,Big 12,6,4,16,4.0,0,2.7,0,0,,0,0.0,4,16,4.0,0,,tanner-mordecai-1
1075,Alex Netherda*,California,Pac-12,13,4,15,3.8,0,1.2,0,0,,0,0.0,4,15,3.8,0,,alex-netherda-1
1076,Braden Mann*,Texas A&M,SEC,13,1,15,15.0,0,1.2,0,0,,0,0.0,1,15,15.0,0,,braden-mann-1
1077,Charleston Rambo*,Oklahoma,Big 12,14,2,15,7.5,0,1.1,43,743,17.3,5,53.1,45,758,16.8,5,,charleston-rambo-1
1078,Cornelious Brown*,Georgia State,Sun Belt,4,4,15,3.8,0,3.8,0,0,,0,0.0,4,15,3.8,0,,cornelious-brown-1
1079,Dominic Davis*,USC,Pac-12,9,2,15,7.5,0,1.7,0,0,,0,0.0,2,15,7.5,0,,dominic-davis-1
1080,Eddie McDoom,South Florida,American,12,2,15,7.5,0,1.3,13,174,13.4,0,14.5,15,189,12.6,0,,eddie-mcdoom-1
1081,Isiah Cox*,Ohio,MAC,13,1,15,15.0,0,1.2,39,663,17.0,2,51.0,40,678,17.0,2,,isiah-cox-1
1082,Jake Neatherton*,Ohio,MAC,7,7,15,2.1,0,2.1,0,0,,0,0.0,7,15,2.1,0,,jake-neatherton-1
1083,James Foster*,Texas A&M,SEC,4,5,15,3.0,0,3.8,0,0,,0,0.0,5,15,3.0,0,,james-foster-1
1084,Jeff Burroughs*,Wyoming,MWC,13,8,15,1.9,0,1.2,0,0,,0,0.0,8,15,1.9,0,,jeff-burroughs-1
1085,Jordan Kempf*,Southern Mississippi,CUSA,8,4,15,3.8,0,1.9,0,0,,0,0.0,4,15,3.8,0,,jordan-kempf-1
1086,Jordon Brookshire*,San Diego State,MWC,3,5,15,3.0,0,5.0,0,0,,0,0.0,5,15,3.0,0,,jordon-brookshire-1
1087,Kavious Price*,Kent State,MAC,13,9,15,1.7,0,1.2,48,508,10.6,3,39.1,57,523,9.2,3,,kavious-price-1
1088,Kirk Johnson*,Texas,Big 12,5,4,15,3.8,0,3.0,0,0,,0,0.0,4,15,3.8,0,,kirk-johnson-5
1089,K.J. Osborn*,Miami (FL),ACC,13,5,15,3.0,0,1.2,50,547,10.9,5,42.1,55,562,10.2,5,,kj-osborn-1
1090,Lucky Jackson*,Western Kentucky,CUSA,13,1,15,15.0,0,1.2,94,1133,12.1,4,87.2,95,1148,12.1,4,,lucky-jackson-1
1091,Nate Jefferson*,Florida International,CUSA,1,1,15,15.0,0,15.0,0,0,,0,0.0,1,15,15.0,0,,nate-jefferson-1
1092,Omar Fattah*,Air Force,MWC,1,3,15,5.0,0,15.0,0,0,,0,0.0,3,15,5.0,0,,omar-fattah-1
1093,Ontaria Wilson*,Florida State,ACC,8,2,15,7.5,1,1.9,21,227,10.8,1,28.4,23,242,10.5,2,,ontaria-wilson-1
1094,Tevin Bush,West Virginia,Big 12,4,3,15,5.0,0,3.8,6,95,15.8,1,23.8,9,110,12.2,1,,tevin-bush-1
1095,Tyrone Scott*,Central Michigan,MAC,14,1,15,15.0,0,1.1,37,650,17.6,5,46.4,38,665,17.5,5,,tyrone-scott-1
1096,A.J. Turner,South Carolina,SEC,7,4,14,3.5,0,2.0,0,0,,0,0.0,4,14,3.5,0,,aj-turner-2
1097,Alan Bowman,Texas Tech,Big 12,3,7,14,2.0,1,4.7,0,0,,0,0.0,7,14,2.0,1,,alan-bowman-1
1098,Branden Mack*,Temple,American,13,2,14,7.0,0,1.1,59,904,15.3,7,69.5,61,918,15.0,7,,branden-mack-1
1099,Dimitri Stanley,Colorado,Pac-12,12,4,14,3.5,0,1.2,29,312,10.8,2,26.0,33,326,9.9,2,,dimitri-stanley-1
1100,Grant Gunnell,Arizona,Pac-12,8,32,14,0.4,1,1.8,0,0,,0,0.0,32,14,0.4,1,,grant-gunnell-1
1101,Jadon Haselwood*,Oklahoma,Big 12,13,3,14,4.7,0,1.1,19,272,14.3,1,20.9,22,286,13.0,1,,jadon-haselwood-1
1102,Jaylon Jackson,Colorado,Pac-12,12,1,14,14.0,0,1.2,4,77,19.3,0,6.4,5,91,18.2,0,,jaylon-jackson-1
1103,Kaelin Byrd,Army,Ind,1,3,14,4.7,0,14.0,0,0,,0,0.0,3,14,4.7,0,,kaelin-byrd-1
1104,Mathew Sexton*,Eastern Michigan,MAC,11,5,14,2.8,0,1.3,34,508,14.9,4,46.2,39,522,13.4,4,,mathew-sexton-1
1105,Matt Romero,New Mexico State,Ind,2,3,14,4.7,0,7.0,0,0,,0,0.0,3,14,4.7,0,,matt-romero-1
1106,Michael Barrett*,Michigan,Big Ten,12,1,14,14.0,0,1.2,0,0,,0,0.0,1,14,14.0,0,,michael-barrett-1
1107,NaJee Thompson*,Georgia Southern,Sun Belt,13,2,14,7.0,0,1.1,6,67,11.2,0,5.2,8,81,10.1,0,,najee-thompson-1
1108,Tony Mathis,West Virginia,Big 12,3,4,14,3.5,0,4.7,3,16,5.3,1,5.3,7,30,4.3,1,,tony-mathis-2
1109,Tyrell Shavers*,Alabama,SEC,13,1,14,14.0,0,1.1,1,20,20.0,0,1.5,2,34,17.0,0,,tyrell-shavers-1
1110,Austin Trammell,Rice,CUSA,12,2,13,6.5,0,1.1,60,726,12.1,4,60.5,62,739,11.9,4,,austin-trammell-1
1111,Ben Wooldridge,Fresno State,MWC,3,2,13,6.5,0,4.3,0,0,,0,0.0,2,13,6.5,0,,ben-wooldridge-1
1112,Bobby Holly*,Louisiana Tech,CUSA,13,5,13,2.6,1,1.0,7,46,6.6,1,3.5,12,59,4.9,2,,bobby-holly-1
1113,Colby Suits,Louisiana-Monroe,Sun Belt,4,5,13,2.6,0,3.3,0,0,,0,0.0,5,13,2.6,0,,colby-suits-1
1114,E.J. Scott,Colorado State,MWC,10,2,13,6.5,0,1.3,15,255,17.0,1,25.5,17,268,15.8,1,,ej-scott-3
1115,Jaelon Darden,North Texas,CUSA,12,2,13,6.5,0,1.1,76,736,9.7,12,61.3,78,749,9.6,12,,jaelon-darden-1
1116,Jason-Matthew Sharsh*,Hawaii,MWC,15,3,13,4.3,0,0.9,87,913,10.5,5,60.9,90,926,10.3,5,,jason-matthew-sharsh-1
1117,Joe Davis,Colorado,Pac-12,11,6,13,2.2,0,1.2,0,0,,0,0.0,6,13,2.2,0,,joe-davis-7
1118,Johnathon Johnson,Missouri,SEC,8,1,13,13.0,0,1.6,29,294,10.1,0,36.8,30,307,10.2,0,,johnathon-johnson-2
1119,Mark Walker*,Navy,American,6,1,13,13.0,0,2.2,0,0,,0,0.0,1,13,13.0,0,,mark-walker-5
1120,Stephan Robinson,Kansas,Big 12,12,4,13,3.3,0,1.1,45,727,16.2,8,60.6,49,740,15.1,8,,stephan-robinson-2
1121,Terrion Avery,South Alabama,Sun Belt,4,8,13,1.6,0,3.3,0,0,,0,0.0,8,13,1.6,0,,terrion-avery-1
1122,Trad Beatty*,Temple,American,2,3,13,4.3,0,6.5,0,0,,0,0.0,3,13,4.3,0,,trad-beatty-1
1123,Wilson Huber*,Cincinnati,American,14,1,13,13.0,0,0.9,0,0,,0,0.0,1,13,13.0,0,,wilson-huber-1
1124,Bailey Cate,Old Dominion,CUSA,12,1,12,12.0,0,1.0,0,0,,0,0.0,1,12,12.0,0,,bailey-cate-1
1125,Brett Kean*,Charlotte,CUSA,8,14,12,0.9,0,1.5,0,0,,0,0.0,14,12,0.9,0,,brett-kean-1
1126,Cole Gest*,Indiana,Big Ten,4,4,12,3.0,1,3.0,5,-1,-0.2,0,-0.3,9,11,1.2,1,,cole-gest-1
1127,Dalton Rigdon,Texas Tech,Big 12,10,6,12,2.0,0,1.2,34,486,14.3,5,48.6,40,498,12.5,5,,dalton-rigdon-1
1128,Dannis Jackson,Ole Miss,SEC,9,2,12,6.0,0,1.3,7,80,11.4,0,8.9,9,92,10.2,0,,dannis-jackson-1
1129,David Bell,Purdue,Big Ten,12,3,12,4.0,1,1.0,86,1035,12.0,7,86.3,89,1047,11.8,8,,david-bell-6
1130,De'marquise Lockridge*,Alabama,SEC,1,2,12,6.0,0,12.0,0,0,,0,0.0,2,12,6.0,0,,demarquise-lockridge-1
1131,Dillon Stoner*,Oklahoma State,Big 12,13,1,12,12.0,0,0.9,52,599,11.5,5,46.1,53,611,11.5,5,,dillon-stoner-1
1132,Donavan Mutin,Houston,American,12,1,12,12.0,0,1.0,0,0,,0,0.0,1,12,12.0,0,,donavan-mutin-1
1133,Emmanuel Logan-Greene,New Mexico,MWC,11,6,12,2.0,0,1.1,19,193,10.2,0,17.5,25,205,8.2,0,,emmanuel-logan-greene-1
1134,James Christian*,Tennessee,SEC,1,2,12,6.0,0,12.0,0,0,,0,0.0,2,12,6.0,0,,james-christian-1
1135,Jay Griffin IV,New Mexico,MWC,6,3,12,4.0,0,2.0,13,118,9.1,0,19.7,16,130,8.1,0,,jay-griffin-iv-1
1136,Micah Cooper*,Oklahoma State,Big 12,8,7,12,1.7,1,1.5,0,0,,0,0.0,7,12,1.7,1,,micah-cooper-1
1137,Nazar Bombata,Arizona,Pac-12,11,2,12,6.0,0,1.1,0,0,,0,0.0,2,12,6.0,0,,nazar-bombata-1
1138,Osiris St. Brown,Stanford,Pac-12,12,2,12,6.0,0,1.0,27,263,9.7,0,21.9,29,275,9.5,0,,osiris-st-brown-1
1139,Patrick McClure*,Clemson,ACC,3,2,12,6.0,0,4.0,0,0,,0,0.0,2,12,6.0,0,,patrick-mcclure-1
1140,Reid Herring,East Carolina,American,3,2,12,6.0,1,4.0,0,0,,0,0.0,2,12,6.0,1,,reid-herring-1
1141,Samuel Cosmi*,Texas,Big 12,13,1,12,12.0,1,0.9,0,0,,0,0.0,1,12,12.0,1,,samuel-cosmi-1
1142,Shaun Bradley*,Temple,American,13,4,12,3.0,0,0.9,0,0,,0,0.0,4,12,3.0,0,,shaun-bradley-1
1143,Simino Walden*,Marshall,CUSA,6,1,12,12.0,0,2.0,1,16,16.0,0,2.7,2,28,14.0,0,,simino-walden-1
1144,Stetson Bennett*,Georgia,SEC,5,4,12,3.0,1,2.4,0,0,,0,0.0,4,12,3.0,1,,stetson-bennett-1
1145,Te'Vailance Hunt,TCU,Big 12,12,3,12,4.0,0,1.0,20,308,15.4,1,25.7,23,320,13.9,1,,tevailance-hunt-2
1146,Trey Lowe III,West Virginia,Big 12,5,3,12,4.0,0,2.4,0,0,,0,0.0,3,12,4.0,0,,trey-lowe-iii-1
1147,Ty Lee,Middle Tennessee State,CUSA,12,4,12,3.0,0,1.0,47,525,11.2,3,43.8,51,537,10.5,3,,ty-lee-1
1148,Brody Hoying*,Eastern Michigan,MAC,13,1,11,11.0,0,0.8,0,0,,0,0.0,1,11,11.0,0,,brody-hoying-1
1149,Bryan Gagg,East Carolina,American,1,1,11,11.0,0,11.0,0,0,,0,0.0,1,11,11.0,0,,bryan-gagg-1
1150,C Stevenson*,Air Force,MWC,6,2,11,5.5,0,1.8,0,0,,0,0.0,2,11,5.5,0,,c-stevenson-1
1151,Connor Thomas*,Indiana,Big Ten,3,6,11,1.8,0,3.7,0,0,,0,0.0,6,11,1.8,0,,connor-thomas-1
1152,Coran Taylor*,Illinois,Big Ten,1,2,11,5.5,0,11.0,0,0,,0,0.0,2,11,5.5,0,,coran-taylor-1
1153,Grayson McCall,Coastal Carolina,Sun Belt,2,2,11,5.5,0,5.5,0,0,,0,0.0,2,11,5.5,0,,grayson-mccall-1
1154,Jake Smith*,Air Force,MWC,1,1,11,11.0,0,11.0,0,0,,0,0.0,1,11,11.0,0,,jake-smith-9
1155,Jamal Parker*,Kent State,MAC,13,1,11,11.0,0,0.8,0,0,,0,0.0,1,11,11.0,0,,jamal-parker-1
1156,JaVonta Payton*,Mississippi State,SEC,13,1,11,11.0,0,0.8,9,147,16.3,0,11.3,10,158,15.8,0,,javonta-payton-1
1157,Kayin White,Louisiana-Monroe,Sun Belt,9,6,11,1.8,1,1.2,2,17,8.5,0,1.9,8,28,3.5,1,,kayin-white-1
1158,Kendall Parham*,UAB,CUSA,13,1,11,11.0,0,0.8,29,608,21.0,6,46.8,30,619,20.6,6,,kendall-parham-1
1159,Kirk Merritt*,Arkansas State,Sun Belt,13,2,11,5.5,0,0.8,70,806,11.5,12,62.0,72,817,11.3,12,,kirk-merritt-1
1160,Kyle Dobbins*,Temple,American,1,2,11,5.5,0,11.0,1,3,3.0,0,3.0,3,14,4.7,0,,kyle-dobbins-1
1161,Kylen Granson*,SMU,American,13,2,11,5.5,0,0.8,43,721,16.8,9,55.5,45,732,16.3,9,,kylen-granson-1
1162,Rontavious Groves*,North Carolina,ACC,13,3,11,3.7,0,0.8,27,250,9.3,1,19.2,30,261,8.7,1,,rontavious-groves-1
1163,Rontavius Groves*,North Carolina,ACC,13,3,11,3.7,0,0.8,27,250,9.3,1,19.2,30,261,8.7,1,,rontavius-groves-1
1164,Steven Duncan*,Western Kentucky,CUSA,3,15,11,0.7,1,3.7,0,0,,0,0.0,15,11,0.7,1,,steven-duncan-1
1165,Tyler Shough*,Oregon,Pac-12,5,2,11,5.5,0,2.2,0,0,,0,0.0,2,11,5.5,0,,tyler-shough-1
1166,Amari McMahon*,Ohio State,Big Ten,1,1,10,10.0,0,10.0,0,0,,0,0.0,1,10,10.0,0,,amari-mcmahon-1
1167,Avery Davis*,Notre Dame,Ind,11,6,10,1.7,0,0.9,10,124,12.4,2,11.3,16,134,8.4,2,,avery-davis-1
1168,Ben Hicks,Arkansas,SEC,7,21,10,0.5,0,1.4,0,0,,0,0.0,21,10,0.5,0,,ben-hicks-1
1169,British Brooks*,North Carolina,ACC,11,3,10,3.3,1,0.9,0,0,,0,0.0,3,10,3.3,1,,british-brooks-1
1170,Chase Cunningham,Middle Tennessee State,CUSA,5,3,10,3.3,1,2.0,0,0,,0,0.0,3,10,3.3,1,,chase-cunningham-1
1171,C.J. Wright*,Georgia Southern,Sun Belt,11,1,10,10.0,0,0.9,0,0,,0,0.0,1,10,10.0,0,,cj-wright-1
1172,Elieyzay Anderson,New Mexico State,Ind,2,3,10,3.3,0,5.0,2,16,8.0,0,8.0,5,26,5.2,0,,elieyzay-anderson-1
1173,Grant Tisdale,Ole Miss,SEC,1,2,10,5.0,0,10.0,0,0,,0,0.0,2,10,5.0,0,,grant-tisdale-1
1174,Jack Colletto,Oregon State,Pac-12,4,6,10,1.7,1,2.5,0,0,,0,0.0,6,10,1.7,1,,jack-colletto-1
1175,Jaylon Redd*,Oregon,Pac-12,12,6,10,1.7,2,0.8,50,465,9.3,7,38.8,56,475,8.5,9,,jaylon-redd-1
1176,Joseph Charlton,South Carolina,SEC,12,1,10,10.0,0,0.8,0,0,,0,0.0,1,10,10.0,0,,joseph-charlton-1
1177,Kearis Jackson*,Georgia,SEC,11,2,10,5.0,0,0.9,5,79,15.8,0,7.2,7,89,12.7,0,,kearis-jackson-1
1178,Kedarian Jones*,Memphis,American,14,2,10,5.0,0,0.7,39,609,15.6,4,43.5,41,619,15.1,4,,kedarian-jones-1
1179,Michael Mathison,Akron,MAC,10,2,10,5.0,0,1.0,31,243,7.8,0,24.3,33,253,7.7,0,,michael-mathison-1
1180,Nate Evans*,UCF,American,13,2,10,5.0,0,0.8,0,0,,0,0.0,2,10,5.0,0,,nate-evans-1
1181,Ramel Keyton*,Tennessee,SEC,12,1,10,10.0,0,0.8,4,104,26.0,0,8.7,5,114,22.8,0,,ramel-keyton-1
1182,Slade Bolden*,Alabama,SEC,13,4,10,2.5,0,0.8,2,34,17.0,0,2.6,6,44,7.3,0,,slade-bolden-1
1183,TJ Green,Northwestern,Big Ten,1,3,10,3.3,0,10.0,0,0,,0,0.0,3,10,3.3,0,,tj-green-2
1184,Tre'Shaun Harrison*,Florida State,ACC,12,4,10,2.5,0,0.8,27,289,10.7,2,24.1,31,299,9.6,2,,treshaun-harrison-1
1185,Zac Everett*,Southern Mississippi,CUSA,13,1,10,10.0,0,0.8,0,0,,0,0.0,1,10,10.0,0,,zac-everett-1
1186,Benjamin Waters*,Air Force,MWC,13,5,9,1.8,0,0.7,22,658,29.9,7,50.6,27,667,24.7,7,,benjamin-waters-1
1187,Chase Wolf*,Wisconsin,Big Ten,3,1,9,9.0,0,3.0,0,0,,0,0.0,1,9,9.0,0,,chase-wolf-1
1188,Da'Joun Hewitt,Purdue,Big Ten,4,6,9,1.5,0,2.3,1,4,4.0,0,1.0,7,13,1.9,0,,dajoun-hewitt-1
1189,Dazz Newsome*,North Carolina,ACC,12,3,9,3.0,0,0.8,72,1018,14.1,10,84.8,75,1027,13.7,10,,dazz-newsome-1
1190,DJ England-Chisolm,Middle Tennessee State,CUSA,9,5,9,1.8,0,1.0,6,162,27.0,1,18.0,11,171,15.5,1,,dj-england-chisolm-1
1191,Dywan Griffin,UTSA,CUSA,11,2,9,4.5,0,0.8,7,26,3.7,0,2.4,9,35,3.9,0,,dywan-griffin-1
1192,Garland LaFrance*,Western Kentucky,CUSA,13,4,9,2.3,0,0.7,4,15,3.8,0,1.2,8,24,3.0,0,,garland-lafrance-1
1193,Jacquez Jones*,Tennessee,SEC,3,1,9,9.0,0,3.0,0,0,,0,0.0,1,9,9.0,0,,jacquez-jones-1
1194,Jake Smith*,Texas,Big 12,13,2,9,4.5,0,0.7,25,274,11.0,6,21.1,27,283,10.5,6,,jake-smith-7
1195,Jarrin Pierce,Middle Tennessee State,CUSA,12,1,9,9.0,0,0.8,42,562,13.4,4,46.8,43,571,13.3,4,,jarrin-pierce-1
1196,Jaylon Hutchings,Texas Tech,Big 12,12,2,9,4.5,0,0.8,0,0,,0,0.0,2,9,4.5,0,,jaylon-hutchings-1
1197,Jeremy Jennings*,Temple,American,10,2,9,4.5,0,0.9,1,6,6.0,0,0.6,3,15,5.0,0,,jeremy-jennings-1
1198,Joey Fields*,Marshall,CUSA,2,1,9,9.0,0,4.5,2,10,5.0,0,5.0,3,19,6.3,0,,joey-fields-1
1199,Kendall Hinton*,Wake Forest,ACC,11,2,9,4.5,0,0.8,73,1001,13.7,4,91.0,75,1010,13.5,4,,kendall-hinton-1
1200,Kinkead Dent,Ole Miss,SEC,1,2,9,4.5,0,9.0,0,0,,0,0.0,2,9,4.5,0,,kinkead-dent-1
1201,Lawrence Johnson,New Mexico,MWC,1,3,9,3.0,0,9.0,0,0,,0,0.0,3,9,3.0,0,,lawrence-johnson-5
1202,Lorenzo Dorr,West Virginia,Big 12,5,2,9,4.5,0,1.8,0,0,,0,0.0,2,9,4.5,0,,lorenzo-dorr-1
1203,Matthew Hill*,Auburn,SEC,13,2,9,4.5,0,0.7,8,46,5.8,0,3.5,10,55,5.5,0,,matthew-hill-1
1204,Michael Collins,TCU,Big 12,2,2,9,4.5,1,4.5,0,0,,0,0.0,2,9,4.5,1,,michael-collins-4
1205,Payton Wilson,North Carolina State,ACC,11,1,9,9.0,0,0.8,0,0,,0,0.0,1,9,9.0,0,,payton-wilson-1
1206,Peter Stehr*,Boston College,ACC,2,3,9,3.0,0,4.5,0,0,,0,0.0,3,9,3.0,0,,peter-stehr-1
1207,Quavaris Crouch*,Tennessee,SEC,13,7,9,1.3,2,0.7,0,0,,0,0.0,7,9,1.3,2,,quavaris-crouch-1
1208,Ronnie Bell*,Michigan,Big Ten,13,1,9,9.0,0,0.7,48,758,15.8,1,58.3,49,767,15.7,1,,ronnie-bell-3
1209,Seth Boomer,Tulsa,American,3,3,9,3.0,0,3.0,0,0,,0,0.0,3,9,3.0,0,,seth-boomer-1
1210,Tabarious Peterson*,Louisville,ACC,13,1,9,9.0,0,0.7,0,0,,0,0.0,1,9,9.0,0,,tabarious-peterson-1
1211,Tamorrion Terry*,Florida State,ACC,13,4,9,2.3,0,0.7,60,1188,19.8,9,91.4,64,1197,18.7,9,,tamorrion-terry-1
1212,Terrell Bynum*,Washington,Pac-12,13,1,9,9.0,0,0.7,31,368,11.9,2,28.3,32,377,11.8,2,,terrell-bynum-1
1213,T'Qele Holmes,Coastal Carolina,Sun Belt,12,2,9,4.5,0,0.8,13,112,8.6,0,9.3,15,121,8.1,0,,tqele-holmes-1
1214,Trae Allen*,Western Michigan,MAC,1,2,9,4.5,0,9.0,0,0,,0,0.0,2,9,4.5,0,,trae-allen-1
1215,Conner Lillig*,Illinois,Big Ten,1,2,8,4.0,0,8.0,0,0,,0,0.0,2,8,4.0,0,,conner-lillig-1
1216,Deondrick Glass*,Oklahoma State,Big 12,1,2,8,4.0,0,8.0,0,0,,0,0.0,2,8,4.0,0,,deondrick-glass-1
1217,Jaylin Bradley,Nebraska,Big Ten,1,2,8,4.0,0,8.0,0,0,,0,0.0,2,8,4.0,0,,jaylin-bradley-1
1218,Joe Mischler*,Ohio,MAC,3,2,8,4.0,0,2.7,0,0,,0,0.0,2,8,4.0,0,,joe-mischler-1
1219,Jordan Waters,Duke,ACC,4,2,8,4.0,0,2.0,0,0,,0,0.0,2,8,4.0,0,,jordan-waters-1
1220,Kyle Trask*,Florida,SEC,12,63,8,0.1,4,0.7,1,4,4.0,0,0.3,64,12,0.2,4,,kyle-trask-1
1221,L Leviston*,Air Force,MWC,1,1,8,8.0,0,8.0,0,0,,0,0.0,1,8,8.0,0,,l-leviston-1
1222,Landen Akers*,Iowa State,Big 12,13,1,8,8.0,0,0.6,9,109,12.1,0,8.4,10,117,11.7,0,,landen-akers-1
1223,Matt Hayball*,Florida Atlantic,CUSA,14,1,8,8.0,0,0.6,0,0,,0,0.0,1,8,8.0,0,,matt-hayball-1
1224,Nikko Remigio*,California,Pac-12,12,3,8,2.7,0,0.7,38,513,13.5,3,42.8,41,521,12.7,3,,nikko-remigio-1
1225,Nykeim Johnson,Syracuse,ACC,12,1,8,8.0,0,0.7,19,99,5.2,0,8.3,20,107,5.4,0,,nykeim-johnson-1
1226,Shi Smith,South Carolina,SEC,10,3,8,2.7,0,0.8,43,489,11.4,2,48.9,46,497,10.8,2,,shi-smith-1
1227,Victor Santiago,Massachusetts,Ind,2,2,8,4.0,0,4.0,0,0,,0,0.0,2,8,4.0,0,,victor-santiago-1
1228,Billy Kemp*,Virginia,ACC,13,2,7,3.5,0,0.5,35,289,8.3,1,22.2,37,296,8.0,1,,billy-kemp-2
1229,Carson Baker*,San Diego State,MWC,2,8,7,0.9,0,3.5,0,0,,0,0.0,8,7,0.9,0,,carson-baker-2
1230,Dylan Wentzel*,Kansas State,Big 12,3,1,7,7.0,0,2.3,0,0,,0,0.0,1,7,7.0,0,,dylan-wentzel-1
1231,Jack Dunn*,Wisconsin,Big Ten,8,2,7,3.5,1,0.9,5,41,8.2,1,5.1,7,48,6.9,2,,jack-dunn-1
1232,Jack Dunn*,Wisconsin,Big Ten,14,2,7,3.5,1,0.5,5,41,8.2,1,2.9,7,48,6.9,2,,jack-dunn-2
1233,Jacoby Clarke*,Baylor,Big 12,1,2,7,3.5,0,7.0,0,0,,0,0.0,2,7,3.5,0,,jacoby-clarke-1
1234,Jamauri Wakefield,Vanderbilt,SEC,1,1,7,7.0,0,7.0,1,10,10.0,0,10.0,2,17,8.5,0,,jamauri-wakefield-1
1235,James Mitchell*,Virginia Tech,ACC,13,5,7,1.4,4,0.5,21,361,17.2,2,27.8,26,368,14.2,6,,james-mitchell-2
1236,Jarrett Guest,Coastal Carolina,Sun Belt,1,1,7,7.0,0,7.0,0,0,,0,0.0,1,7,7.0,0,,jarrett-guest-1
1237,Jeremiah Hall*,Oklahoma,Big 12,14,2,7,3.5,0,0.5,16,169,10.6,3,12.1,18,176,9.8,3,,jeremiah-hall-1
1238,Jeremiah Payton*,Miami (FL),ACC,4,1,7,7.0,0,1.8,1,23,23.0,0,5.8,2,30,15.0,0,,jeremiah-payton-1
1239,Jesse Matthews*,San Diego State,MWC,13,1,7,7.0,0,0.5,48,633,13.2,2,48.7,49,640,13.1,2,,jesse-matthews-1
1240,Karmi Mackey*,Eastern Michigan,MAC,7,3,7,2.3,0,1.0,0,0,,0,0.0,3,7,2.3,0,,karmi-mackey-1
1241,KeShun Wells,Ole Miss,SEC,8,1,7,7.0,0,0.9,0,0,,0,0.0,1,7,7.0,0,,keshun-wells-1
1242,Kyle Philips,UCLA,Pac-12,12,1,7,7.0,0,0.6,60,681,11.4,5,56.8,61,688,11.3,5,,kyle-philips-4
1243,Malik Henry*,Nevada,MWC,3,11,7,0.6,0,2.3,0,0,,0,0.0,11,7,0.6,0,,malik-henry-3
1244,Nathan Stanley*,Iowa,Big Ten,13,76,7,0.1,1,0.5,0,0,,0,0.0,76,7,0.1,1,,nathan-stanley-2
1245,Reggie Roberson Jr.*,SMU,American,8,2,7,3.5,0,0.9,43,803,18.7,6,100.4,45,810,18.0,6,,reggie-roberson-jr-1
1246,Sean Riley,Syracuse,ACC,12,5,7,1.4,0,0.6,36,275,7.6,1,22.9,41,282,6.9,1,,sean-riley-2
1247,Steve Jenkins,Nevada-Las Vegas,MWC,11,1,7,7.0,0,0.6,23,386,16.8,2,35.1,24,393,16.4,2,,steve-jenkins-3
1248,Tate Martell*,Miami (FL),ACC,5,7,7,1.0,0,1.4,0,0,,0,0.0,7,7,1.0,0,,tate-martell-1
1249,Van Jefferson*,Florida,SEC,13,1,7,7.0,0,0.5,49,657,13.4,6,50.5,50,664,13.3,6,,van-jefferson-1
1250,Alec Wyble-Meza*,BYU,Ind,1,3,6,2.0,0,6.0,0,0,,0,0.0,3,6,2.0,0,,alec-wyble-meza-1
1251,Brandon Aiyuk*,Arizona State,Pac-12,12,1,6,6.0,0,0.5,65,1192,18.3,8,99.3,66,1198,18.2,8,,brandon-aiyuk-1
1252,Cameron Davis*,Washington,Pac-12,2,2,6,3.0,0,3.0,0,0,,0,0.0,2,6,3.0,0,,cameron-davis-3
1253,Chandler Rogers*,Southern Mississippi,CUSA,2,2,6,3.0,0,3.0,0,0,,0,0.0,2,6,3.0,0,,chandler-rogers-2
1254,Cole Snyder,Rutgers,Big Ten,3,1,6,6.0,0,2.0,0,0,,0,0.0,1,6,6.0,0,,cole-snyder-2
1255,Donny Navarro*,Illinois,Big Ten,11,1,6,6.0,0,0.5,27,345,12.8,2,31.4,28,351,12.5,2,,donny-navarro-1
1256,Donny Navarro III*,Illinois,Big Ten,13,1,6,6.0,0,0.5,27,345,12.8,2,26.5,28,351,12.5,2,,donny-navarro-iii-1
1257,Drew Lisk*,Utah,Pac-12,4,2,6,3.0,0,1.5,0,0,,0,0.0,2,6,3.0,0,,drew-lisk-1
1258,Dru Brown*,Oklahoma State,Big 12,7,23,6,0.3,1,0.9,0,0,,0,0.0,23,6,0.3,1,,dru-brown-1
1259,Eddie Daugherty*,Eastern Michigan,MAC,10,1,6,6.0,0,0.6,3,32,10.7,0,3.2,4,38,9.5,0,,eddie-daugherty-1
1260,Garret McGuire*,Baylor,Big 12,3,1,6,6.0,0,2.0,0,0,,0,0.0,1,6,6.0,0,,garret-mcguire-1
1261,Graham Mertz*,Wisconsin,Big Ten,2,2,6,3.0,0,3.0,0,0,,0,0.0,2,6,3.0,0,,graham-mertz-1
1262,Gunner Romney*,BYU,Ind,13,1,6,6.0,0,0.5,31,377,12.2,2,29.0,32,383,12.0,2,,gunner-romney-1
1263,Isaiah Spencer,Old Dominion,CUSA,11,1,6,6.0,0,0.5,5,63,12.6,1,5.7,6,69,11.5,1,,isaiah-spencer-2
1264,Jackson Tyner,Texas Tech,Big 12,3,1,6,6.0,0,2.0,0,0,,0,0.0,1,6,6.0,0,,jackson-tyner-1
1265,Jai Williams,Coastal Carolina,Sun Belt,10,1,6,6.0,0,0.6,9,136,15.1,2,13.6,10,142,14.2,2,,jai-williams-1
1266,Jakairi Moses*,Western Kentucky,CUSA,1,1,6,6.0,0,6.0,3,51,17.0,0,51.0,4,57,14.3,0,,jakairi-moses-1
1267,Jake Camarda*,Georgia,SEC,14,1,6,6.0,0,0.4,0,0,,0,0.0,1,6,6.0,0,,jake-camarda-1
1268,Josh Ali*,Kentucky,SEC,13,2,6,3.0,0,0.5,23,233,10.1,3,17.9,25,239,9.6,3,,josh-ali-1
1269,Markenzy Pierre,Syracuse,ACC,12,5,6,1.2,0,0.5,0,0,,0,0.0,5,6,1.2,0,,markenzy-pierre-1
1270,Masen Wake*,BYU,Ind,12,3,6,2.0,0,0.5,0,0,,0,0.0,3,6,2.0,0,,masen-wake-1
1271,Riley Lees,Northwestern,Big Ten,12,3,6,2.0,0,0.5,51,430,8.4,2,35.8,54,436,8.1,2,,riley-lees-1
1272,Spencer Tears,Northern Illinois,MAC,12,1,6,6.0,0,0.5,23,370,16.1,2,30.8,24,376,15.7,2,,spencer-tears-1
1273,Chris Olave*,Ohio State,Big Ten,14,2,5,2.5,0,0.4,49,849,17.3,12,60.6,51,854,16.7,12,,chris-olave-1
1274,Danny Pinter,Ball State,MAC,12,1,5,5.0,1,0.4,0,0,,0,0.0,1,5,5.0,1,,danny-pinter-1
1275,Darius Boone Jr.*,Eastern Michigan,MAC,2,2,5,2.5,0,2.5,0,0,,0,0.0,2,5,2.5,0,,darius-boone-jr-1
1276,Deddrick Thomas*,Mississippi State,SEC,13,1,5,5.0,0,0.4,30,401,13.4,2,30.8,31,406,13.1,2,,deddrick-thomas-1
1277,Dominick Wood-Anderson*,Tennessee,SEC,13,1,5,5.0,0,0.4,21,268,12.8,1,20.6,22,273,12.4,1,,dominick-wood-anderson-1
1278,D'Vaughn Pennamon,Ole Miss,SEC,10,3,5,1.7,0,0.5,0,0,,0,0.0,3,5,1.7,0,,dvaughn-pennamon-1
1279,Ishmael Davis,Texas State,Sun Belt,12,1,5,5.0,0,0.4,0,0,,0,0.0,1,5,5.0,0,,ishmael-davis-1
1280,Jake Rogers,Bowling Green,MAC,10,2,5,2.5,0,0.5,3,11,3.7,0,1.1,5,16,3.2,0,,jake-rogers-2
1281,Ja'Marr Chase*,LSU,SEC,14,1,5,5.0,0,0.4,84,1780,21.2,20,127.1,85,1785,21.0,20,AA,jamarr-chase-1
1282,Jaylen Waddle*,Alabama,SEC,13,1,5,5.0,0,0.4,33,560,17.0,6,43.1,34,565,16.6,6,,jaylen-waddle-1
1283,Josh Vann,South Carolina,SEC,9,1,5,5.0,0,0.6,19,171,9.0,0,19.0,20,176,8.8,0,,josh-vann-1
1284,Laress Nelson*,Michigan State,Big Ten,13,1,5,5.0,0,0.4,4,48,12.0,0,3.7,5,53,10.6,0,,laress-nelson-1
1285,Matlin Marshall*,Georgia State,Sun Belt,13,1,5,5.0,0,0.4,10,75,7.5,0,5.8,11,80,7.3,0,,matlin-marshall-1
1286,Oliver Martin*,Iowa,Big Ten,8,1,5,5.0,0,0.6,5,28,5.6,1,3.5,6,33,5.5,1,,oliver-martin-1
1287,Prather Hudson*,Georgia,SEC,14,1,5,5.0,0,0.4,1,14,14.0,0,1.0,2,19,9.5,0,,prather-hudson-1
1288,Terrell Perriman*,Utah,Pac-12,10,1,5,5.0,0,0.5,2,9,4.5,0,0.9,3,14,4.7,0,,terrell-perriman-1
1289,Tommy Townsend*,Florida,SEC,13,3,5,1.7,0,0.4,0,0,,0,0.0,3,5,1.7,0,,tommy-townsend-1
1290,Tony Nicholson,New Mexico State,Ind,12,3,5,1.7,0,0.4,60,644,10.7,6,53.7,63,649,10.3,6,,tony-nicholson-1
1291,Will Swinney*,Clemson,ACC,15,2,5,2.5,0,0.3,12,94,7.8,0,6.3,14,99,7.1,0,,will-swinney-1
1292,Xavier Martin,Texas Tech,Big 12,2,1,5,5.0,0,2.5,1,5,5.0,0,2.5,2,10,5.0,0,,xavier-martin-2
1293,Zion Echols,Fresno State,MWC,5,3,5,1.7,0,1.0,0,0,,0,0.0,3,5,1.7,0,,zion-echols-1
1294,Austin Kafentzis*,BYU,Ind,12,2,4,2.0,0,0.3,0,0,,0,0.0,2,4,2.0,0,,austin-kafentzis-1
1295,Ben Putman*,Nevada,MWC,13,1,4,4.0,0,0.3,26,297,11.4,0,22.8,27,301,11.1,0,,ben-putman-1
1296,Bubba Baxa*,Miami (FL),ACC,13,1,4,4.0,0,0.3,0,0,,0,0.0,1,4,4.0,0,,bubba-baxa-1
1297,Chandler Fields*,Louisiana,Sun Belt,3,1,4,4.0,0,1.3,0,0,,0,0.0,1,4,4.0,0,,chandler-fields-1
1298,C.J. Brewer,Coastal Carolina,Sun Belt,12,1,4,4.0,0,0.3,0,0,,0,0.0,1,4,4.0,0,,cj-brewer-2
1299,C.J Sanders*,SMU,American,13,2,4,2.0,0,0.3,11,153,13.9,0,11.8,13,157,12.1,0,,cj-sanders-1
1300,Cornelius McCoy*,Georgia State,Sun Belt,13,1,4,4.0,0,0.3,70,757,10.8,5,58.2,71,761,10.7,5,,cornelius-mccoy-1
1301,Cornell Hendrick,Old Dominion,CUSA,10,5,4,0.8,0,0.4,5,34,6.8,0,3.4,10,38,3.8,0,,cornell-hendrick-1
1302,Cornell Hendrick Jr.,Old Dominion,CUSA,6,5,4,0.8,0,0.7,5,34,6.8,0,5.7,10,38,3.8,0,,cornell-hendrick-jr-1
1303,Dalton Schoen*,Kansas State,Big 12,13,1,4,4.0,0,0.3,37,579,15.6,4,44.5,38,583,15.3,4,,dalton-schoen-1
1304,Dontay Demus,Maryland,Big Ten,12,1,4,4.0,0,0.3,41,625,15.2,6,52.1,42,629,15.0,6,,dontay-demus-1
1305,Ethan Dedeaux*,San Diego State,MWC,11,2,4,2.0,0,0.4,7,121,17.3,1,11.0,9,125,13.9,1,,ethan-dedeaux-1
1306,Garrett Collingham*,Boise State,MWC,14,2,4,2.0,1,0.3,13,113,8.7,3,8.1,15,117,7.8,4,,garrett-collingham-1
1307,Isaiah Zuber*,Mississippi State,SEC,13,3,4,1.3,0,0.3,14,211,15.1,2,16.2,17,215,12.6,2,,isaiah-zuber-1
1308,Jack Snyder,San Jose State,MWC,12,1,4,4.0,1,0.3,0,0,,0,0.0,1,4,4.0,1,,jack-snyder-1
1309,Jamari Peacock*,Virginia,ACC,14,1,4,4.0,0,0.3,0,0,,0,0.0,1,4,4.0,0,,jamari-peacock-1
1310,James Burns*,Miami (OH),MAC,12,2,4,2.0,0,0.3,20,506,25.3,1,42.2,22,510,23.2,1,,james-burns-2
1311,James Maye*,Miami (OH),MAC,10,2,4,2.0,0,0.4,20,506,25.3,1,50.6,22,510,23.2,1,,james-maye-1
1312,Jared Bair*,Air Force,MWC,6,1,4,4.0,0,0.7,0,0,,0,0.0,1,4,4.0,0,,jared-bair-1
1313,Jonathan Nance,Missouri,SEC,12,1,4,4.0,0,0.3,31,458,14.8,4,38.2,32,462,14.4,4,,jonathan-nance-1
1314,Josh Holl*,Tulane,American,1,1,4,4.0,0,4.0,0,0,,0,0.0,1,4,4.0,0,,josh-holl-1
1315,Josh Palmer*,Tennessee,SEC,13,2,4,2.0,0,0.3,34,457,13.4,1,35.2,36,461,12.8,1,,josh-palmer-1
1316,JT Shrout*,Tennessee,SEC,5,3,4,1.3,0,0.8,0,0,,0,0.0,3,4,1.3,0,,jt-shrout-1
1317,Malik Dear*,Mississippi State,SEC,12,3,4,1.3,0,0.3,3,36,12.0,0,3.0,6,40,6.7,0,,malik-dear-1
1318,Mohamed Jabbie,Rutgers,Big Ten,10,1,4,4.0,0,0.4,14,149,10.6,1,14.9,15,153,10.2,1,,mohamed-jabbie-1
1319,Myron Mitchell*,UAB,CUSA,14,1,4,4.0,0,0.3,34,554,16.3,4,39.6,35,558,15.9,4,,myron-mitchell-1
1320,Noah Bean,Nevada-Las Vegas,MWC,11,1,4,4.0,0,0.4,22,336,15.3,2,30.5,23,340,14.8,2,,noah-bean-1
1321,Qawi Ntsasa*,Air Force,MWC,1,1,4,4.0,0,4.0,0,0,,0,0.0,1,4,4.0,0,,qawi-ntsasa-1
1322,Rashad Mosley*,UAB,CUSA,1,1,4,4.0,0,4.0,0,0,,0,0.0,1,4,4.0,0,,rashad-mosley-1
1323,Romello Ross*,Central Michigan,MAC,2,2,4,2.0,0,2.0,0,0,,0,0.0,2,4,2.0,0,,romello-ross-1
1324,Shameen Jones,Rutgers,Big Ten,10,1,4,4.0,0,0.4,2,15,7.5,0,1.5,3,19,6.3,0,,shameen-jones-1
1325,Ta'Ron Madison,Oregon State,Pac-12,1,2,4,2.0,0,4.0,0,0,,0,0.0,2,4,2.0,0,,taron-madison-1
1326,Thomas Hennigan*,Appalachian State,Sun Belt,14,1,4,4.0,0,0.3,61,773,12.7,6,55.2,62,777,12.5,6,,thomas-hennigan-1
1327,Thomas Vieira,New Mexico,MWC,12,1,4,4.0,0,0.3,4,30,7.5,0,2.5,5,34,6.8,0,,thomas-vieira-1
1328,T.J. Deshields,Akron,MAC,3,2,4,2.0,0,1.3,0,0,,0,0.0,2,4,2.0,0,,tj-deshields-1
1329,Torry Locklin,Kansas,Big 12,4,3,4,1.3,0,1.0,0,0,,0,0.0,3,4,1.3,0,,torry-locklin-1
1330,Tucker Day*,Mississippi State,SEC,13,1,4,4.0,0,0.3,0,0,,0,0.0,1,4,4.0,0,,tucker-day-1
1331,Tyler Walton*,Ohio,MAC,13,4,4,1.0,0,0.3,18,199,11.1,1,15.3,22,203,9.2,1,,tyler-walton-1
1332,Will Drawdy*,Wake Forest,ACC,4,2,4,2.0,0,1.0,0,0,,0,0.0,2,4,2.0,0,,will-drawdy-1
1333,Xavier Weaver,South Florida,American,12,1,4,4.0,0,0.3,12,166,13.8,0,13.8,13,170,13.1,0,,xavier-weaver-1
1334,Aaron Allen*,Louisiana Tech,CUSA,6,13,3,0.2,0,0.5,0,0,,0,0.0,13,3,0.2,0,,aaron-allen-1
1335,Aaron Hackett,Syracuse,ACC,12,1,3,3.0,0,0.3,23,205,8.9,6,17.1,24,208,8.7,6,,aaron-hackett-1
1336,Alfred Armour,Purdue,Big Ten,12,2,3,1.5,0,0.3,1,0,0.0,0,0.0,3,3,1.0,0,,alfred-armour-1
1337,Anthony Thompson,Northern Illinois,MAC,2,1,3,3.0,0,1.5,0,0,,0,0.0,1,3,3.0,0,,anthony-thompson-3
1338,Ben Mason*,Michigan,Big Ten,13,1,3,3.0,0,0.2,0,0,,0,0.0,1,3,3.0,0,,ben-mason-1
1339,Ben Peterson*,Air Force,MWC,13,1,3,3.0,0,0.2,3,25,8.3,0,1.9,4,28,7.0,0,,ben-peterson-1
1340,Boogie Knight,Akron,MAC,12,1,3,3.0,0,0.3,31,430,13.9,0,35.8,32,433,13.5,0,,boogie-knight-1
1341,Brady Ross*,Iowa,Big Ten,13,6,3,0.5,1,0.2,1,4,4.0,0,0.3,7,7,1.0,1,,brady-ross-1
1342,Brenden Fulton,Colorado State,MWC,11,1,3,3.0,0,0.3,2,16,8.0,0,1.5,3,19,6.3,0,,brenden-fulton-1
1343,Calvin Austin III*,Memphis,American,13,4,3,0.8,1,0.2,17,315,18.5,3,24.2,21,318,15.1,4,,calvin-austin-iii-1
1344,CJ O'Grady,Arkansas,SEC,7,1,3,3.0,0,0.4,33,372,11.3,3,53.1,34,375,11.0,3,,cj-ogrady-1
1345,Damon Hazelton Jr.*,Virginia Tech,ACC,10,1,3,3.0,0,0.3,31,527,17.0,8,52.7,32,530,16.6,8,,damon-hazelton-jr-1
1346,Daniel Richardson*,Central Michigan,MAC,3,1,3,3.0,0,1.0,0,0,,0,0.0,1,3,3.0,0,,daniel-richardson-1
1347,Dashaun Jerkins,Vanderbilt,SEC,11,1,3,3.0,0,0.3,0,0,,0,0.0,1,3,3.0,0,,dashaun-jerkins-1
1348,Dayan Ghanwoloku*,BYU,Ind,12,3,3,1.0,1,0.3,0,0,,0,0.0,3,3,1.0,1,,dayan-ghanwoloku-1
1349,Deshaunte Jones*,Iowa State,Big 12,13,4,3,0.8,0,0.2,76,877,11.5,2,67.5,80,880,11.0,2,,deshaunte-jones-1
1350,Elijah Lilly,New Mexico,MWC,3,2,3,1.5,0,1.0,7,95,13.6,0,31.7,9,98,10.9,0,,elijah-lilly-1
1351,Ezra Cleveland*,Boise State,MWC,13,1,3,3.0,0,0.2,0,0,,0,0.0,1,3,3.0,0,,ezra-cleveland-1
1352,Hezekiah Grimsley*,Virginia Tech,ACC,12,1,3,3.0,0,0.3,10,170,17.0,2,14.2,11,173,15.7,2,,hezekiah-grimsley-1
1353,Jason Whittaker,Northwestern,Big Ten,2,2,3,1.5,0,1.5,0,0,,0,0.0,2,3,1.5,0,,jason-whittaker-1
1354,Jerome Buckner*,Ohio,MAC,10,1,3,3.0,0,0.3,18,326,18.1,2,32.6,19,329,17.3,2,,jerome-buckner-1
1355,John Haggerty*,Western Kentucky,CUSA,13,1,3,3.0,0,0.2,0,0,,0,0.0,1,3,3.0,0,,john-haggerty-1
1356,Justice McCoy,Colorado State,MWC,3,2,3,1.5,0,1.0,0,0,,0,0.0,2,3,1.5,0,,justice-mccoy-1
1357,Khyiris Tonga*,BYU,Ind,13,1,3,3.0,1,0.2,0,0,,0,0.0,1,3,3.0,1,,khyiris-tonga-1
1358,Mike Carrigan*,Kent State,MAC,11,1,3,3.0,0,0.3,42,569,13.5,5,51.7,43,572,13.3,5,,mike-carrigan-1
1359,Odunayo Seriki,South Florida,American,9,1,3,3.0,0,0.3,0,0,,0,0.0,1,3,3.0,0,,odunayo-seriki-1
1360,Parker White,South Carolina,SEC,12,1,3,3.0,0,0.3,0,0,,0,0.0,1,3,3.0,0,,parker-white-2
1361,Perry Carter,Louisiana-Monroe,Sun Belt,12,2,3,1.5,0,0.3,15,305,20.3,0,25.4,17,308,18.1,0,,perry-carter-2
1362,Randall Johnson,Middle Tennessee State,CUSA,1,2,3,1.5,0,3.0,0,0,,0,0.0,2,3,1.5,0,,randall-johnson-1
1363,Richie Worship,Purdue,Big Ten,1,1,3,3.0,0,3.0,0,0,,0,0.0,1,3,3.0,0,,richie-worship-1
1364,Rondale Moore,Purdue,Big Ten,4,3,3,1.0,0,0.8,29,387,13.3,2,96.8,32,390,12.2,2,,rondale-moore-1
1365,Ryan Bujcevski*,Texas,Big 12,9,1,3,3.0,0,0.3,0,0,,0,0.0,1,3,3.0,0,,ryan-bujcevski-1
1366,Trishton Jackson,Syracuse,ACC,12,2,3,1.5,0,0.3,66,1023,15.5,11,85.3,68,1026,15.1,11,,trishton-jackson-1
1367,Ty Lucas*,Clemson,ACC,6,1,3,3.0,0,0.5,0,0,,0,0.0,1,3,3.0,0,,ty-lucas-1
1368,Wykeen Gill*,Kansas State,Big 12,11,1,3,3.0,0,0.3,16,273,17.1,2,24.8,17,276,16.2,2,,wykeen-gill-1
1369,Ahmarean Brown,Georgia Tech,ACC,12,1,2,2.0,0,0.2,21,396,18.9,7,33.0,22,398,18.1,7,,ahmarean-brown-1
1370,A.J. Green*,Oklahoma State,Big 12,13,1,2,2.0,0,0.2,0,0,,0,0.0,1,2,2.0,0,,aj-green-4
1371,Akeem Hayes*,Kentucky,SEC,8,1,2,2.0,0,0.3,1,5,5.0,0,0.6,2,7,3.5,0,,akeem-hayes-1
1372,Alexy Jean-Baptiste*,Florida International,CUSA,10,1,2,2.0,0,0.2,0,0,,0,0.0,1,2,2.0,0,,alexy-jean-baptiste-1
1373,Austen Pleasants*,Ohio,MAC,13,1,2,2.0,1,0.2,0,0,,0,0.0,1,2,2.0,1,,austen-pleasants-1
1374,Austin Allen,Nebraska,Big Ten,12,1,2,2.0,0,0.2,7,83,11.9,0,6.9,8,85,10.6,0,,austin-allen-2
1375,Charles Lamar,Bowling Green,MAC,2,4,2,0.5,0,1.0,0,0,,0,0.0,4,2,0.5,0,,charles-lamar-1
1376,Chris Cunningham,Old Dominion,CUSA,10,3,2,0.7,0,0.2,9,95,10.6,0,9.5,12,97,8.1,0,,chris-cunningham-2
1377,Chris Elmore,Syracuse,ACC,12,2,2,1.0,0,0.2,0,0,,0,0.0,2,2,1.0,0,,chris-elmore-1
1378,Chris Finke*,Notre Dame,Ind,13,2,2,1.0,0,0.2,41,456,11.1,4,35.1,43,458,10.7,4,,chris-finke-1
1379,Connor Bazelak,Missouri,SEC,3,7,2,0.3,0,0.7,0,0,,0,0.0,7,2,0.3,0,,connor-bazelak-1
1380,Drew Keszei*,Ohio,MAC,2,1,2,2.0,0,1.0,0,0,,0,0.0,1,2,2.0,0,,drew-keszei-1
1381,Dyami Brown*,North Carolina,ACC,13,1,2,2.0,0,0.2,51,1034,20.3,12,79.5,52,1036,19.9,12,,dyami-brown-1
1382,Edward Saydee*,Temple,American,4,2,2,1.0,0,0.5,0,0,,0,0.0,2,2,1.0,0,,edward-saydee-1
1383,Forest Mckee,UTEP,CUSA,11,1,2,2.0,0,0.2,1,40,40.0,0,3.6,2,42,21.0,0,,forest-mckee-1
1384,Jake Sopko*,Cincinnati,American,1,1,2,2.0,0,2.0,0,0,,0,0.0,1,2,2.0,0,,jake-sopko-1
1385,Jalon Calhoun,Duke,ACC,12,4,2,0.5,0,0.2,46,420,9.1,4,35.0,50,422,8.4,4,,jalon-calhoun-1
1386,Jamaal Neal,Nevada-Las Vegas,MWC,11,2,2,1.0,0,0.2,2,16,8.0,0,1.5,4,18,4.5,0,,jamaal-neal-1
1387,Jamal Brooks,Missouri,SEC,12,1,2,2.0,0,0.2,0,0,,0,0.0,1,2,2.0,0,,jamal-brooks-1
1388,Johnathan Bennett*,Liberty,Ind,2,1,2,2.0,0,1.0,0,0,,0,0.0,1,2,2.0,0,,johnathan-bennett-1
1389,Jonah White*,Baylor,Big 12,1,1,2,2.0,0,2.0,0,0,,0,0.0,1,2,2.0,0,,jonah-white-1
1390,Maverick Wolfley,Akron,MAC,7,1,2,2.0,0,0.3,5,68,13.6,2,9.7,6,70,11.7,2,,maverick-wolfley-1
1391,Micah Murphy,Troy,Sun Belt,12,1,2,2.0,0,0.2,0,0,,0,0.0,1,2,2.0,0,,micah-murphy-1
1392,Michael Young*,Notre Dame,Ind,3,1,2,2.0,0,0.7,6,21,3.5,0,7.0,7,23,3.3,0,,michael-young-4
1393,Milton Wright,Purdue,Big Ten,11,1,2,2.0,0,0.2,18,288,16.0,1,26.2,19,290,15.3,1,,milton-wright-1
1394,Nico Ragaini*,Iowa,Big Ten,13,1,2,2.0,0,0.2,46,439,9.5,2,33.8,47,441,9.4,2,,nico-ragaini-1
1395,Robert Gross*,Air Force,MWC,1,1,2,2.0,0,2.0,0,0,,0,0.0,1,2,2.0,0,,robert-gross-1
1396,Skyy Moore*,Western Michigan,MAC,13,1,2,2.0,1,0.2,51,802,15.7,3,61.7,52,804,15.5,4,,skyy-moore-1
1397,Spencer Nigh*,Auburn,SEC,13,1,2,2.0,0,0.2,2,33,16.5,0,2.5,3,35,11.7,0,,spencer-nigh-1
1398,Trevon Sidney*,Illinois,Big Ten,5,1,2,2.0,0,0.4,16,123,7.7,1,24.6,17,125,7.4,1,,trevon-sidney-1
1399,Tyson Dyer,New Mexico,MWC,12,1,2,2.0,0,0.2,0,0,,0,0.0,1,2,2.0,0,,tyson-dyer-1
1400,Winston Wright,West Virginia,Big 12,10,1,2,2.0,0,0.2,19,97,5.1,0,9.7,20,99,5.0,0,,winston-wright-1
1401,Adam Prentice,Colorado State,MWC,12,1,1,1.0,0,0.1,7,44,6.3,0,3.7,8,45,5.6,0,,adam-prentice-1
1402,Alante Thomas*,Michigan State,Big Ten,2,2,1,0.5,1,0.5,0,0,,0,0.0,2,1,0.5,1,,alante-thomas-1
1403,Alphonzo Andrews Jr.*,Wyoming,MWC,1,1,1,1.0,0,1.0,0,0,,0,0.0,1,1,1.0,0,,alphonzo-andrews-jr-1
1404,Anthony Hawkins,Colorado State,MWC,12,1,1,1.0,0,0.1,0,0,,0,0.0,1,1,1.0,0,,anthony-hawkins-1
1405,Ben Miles,Kansas,Big 12,11,3,1,0.3,0,0.1,1,2,2.0,0,0.2,4,3,0.8,0,,ben-miles-1
1406,Brandon Walters,Army,Ind,13,4,1,0.3,0,0.1,4,96,24.0,0,7.4,8,97,12.1,0,,brandon-walters-1
1407,Cedric Patterson III,New Mexico,MWC,12,2,1,0.5,0,0.1,8,198,24.8,2,16.5,10,199,19.9,2,,cedric-patterson-iii-1
1408,Chux Nwabuko III,Texas Tech,Big 12,7,1,1,1.0,0,0.1,0,0,,0,0.0,1,1,1.0,0,,chux-nwabuko-iii-1
1409,Demarcus Townsend*,Florida International,CUSA,12,1,1,1.0,0,0.1,0,0,,0,0.0,1,1,1.0,0,,demarcus-townsend-1
1410,Dustin Burkhart,Akron,MAC,4,1,1,1.0,0,0.3,15,320,21.3,1,80.0,16,321,20.1,1,,dustin-burkhart-1
1411,Grant Wells*,Marshall,CUSA,1,1,1,1.0,0,1.0,0,0,,0,0.0,1,1,1.0,0,,grant-wells-1
1412,Hudson Hall,Kansas,Big 12,9,1,1,1.0,1,0.1,0,0,,0,0.0,1,1,1.0,1,,hudson-hall-1
1413,Isaac Guerendo*,Wisconsin,Big Ten,6,1,1,1.0,0,0.2,1,3,3.0,0,0.5,2,4,2.0,0,,isaac-guerendo-1
1414,Jace James,Northwestern,Big Ten,9,1,1,1.0,0,0.1,10,92,9.2,2,10.2,11,93,8.5,2,,jace-james-1
1415,Jacob Huesman*,Appalachian State,Sun Belt,5,1,1,1.0,0,0.2,0,0,,0,0.0,1,1,1.0,0,,jacob-huesman-1
1416,Jakyle Holmes,Louisiana-Monroe,Sun Belt,8,6,1,0.2,0,0.1,0,0,,0,0.0,6,1,0.2,0,,jakyle-holmes-1
1417,Jalen Walker*,Miami (OH),MAC,14,3,1,0.3,0,0.1,24,418,17.4,2,29.9,27,419,15.5,2,,jalen-walker-2
1418,Jaret Curtis*,Western Michigan,MAC,3,1,1,1.0,0,0.3,0,0,,0,0.0,1,1,1.0,0,,jaret-curtis-1
1419,Jerry Jeudy*,Alabama,SEC,13,1,1,1.0,0,0.1,77,1163,15.1,10,89.5,78,1164,14.9,10,,jerry-jeudy-1
1420,John Simpson*,Clemson,ACC,14,1,1,1.0,1,0.1,0,0,,0,0.0,1,1,1.0,1,AA,john-simpson-3
1421,Julian Hicks,Akron,MAC,10,1,1,1.0,0,0.1,32,212,6.6,2,21.2,33,213,6.5,2,,julian-hicks-1
1422,Kierston Harvey*,Georgia State,Sun Belt,3,1,1,1.0,0,0.3,0,0,,0,0.0,1,1,1.0,0,,kierston-harvey-1
1423,K.J. Hill*,Ohio State,Big Ten,14,1,1,1.0,0,0.1,57,636,11.2,10,45.4,58,637,11.0,10,,kj-hill-1
1424,Koby Bullard*,Baylor,Big 12,14,1,1,1.0,0,0.1,1,8,8.0,0,0.6,2,9,4.5,0,,koby-bullard-1
1425,Nate Cottrell,Georgia Tech,ACC,12,2,1,0.5,0,0.1,3,60,20.0,1,5.0,5,61,12.2,1,,nate-cottrell-1
1426,Nicholas Capatina*,Michigan,Big Ten,2,2,1,0.5,0,0.5,0,0,,0,0.0,2,1,0.5,0,,nicholas-capatina-1
1427,Nick Ast*,Kansas State,Big 12,5,2,1,0.5,0,0.2,0,0,,0,0.0,2,1,0.5,0,,nick-ast-1
1428,Nick Ralston*,Louisiana,Sun Belt,14,1,1,1.0,0,0.1,15,100,6.7,4,7.1,16,101,6.3,4,,nick-ralston-1
1429,Nolan Henry*,Notre Dame,Ind,2,1,1,1.0,0,0.5,0,0,,0,0.0,1,1,1.0,0,,nolan-henry-1
1430,Octavious Cooley,Ole Miss,SEC,12,1,1,1.0,0,0.1,13,162,12.5,0,13.5,14,163,11.6,0,,octavious-cooley-1
1431,Penei Sewell*,Oregon,Pac-12,14,1,1,1.0,0,0.1,0,0,,0,0.0,1,1,1.0,0,AA,penei-sewell-1
1432,Quan Hampton,Kansas,Big 12,7,1,1,1.0,0,0.1,2,19,9.5,1,2.7,3,20,6.7,1,,quan-hampton-1
1433,Quayvon Skanes,Connecticut,American,12,1,1,1.0,0,0.1,0,0,,0,0.0,1,1,1.0,0,,quayvon-skanes-1
1434,Quez Watkins*,Southern Mississippi,CUSA,12,1,1,1.0,0,0.1,64,1178,18.4,6,98.2,65,1179,18.1,6,,quez-watkins-1
1435,Race Porter*,Washington,Pac-12,13,1,1,1.0,0,0.1,0,0,,0,0.0,1,1,1.0,0,,race-porter-1
1436,Ricky Pearsall*,Arizona State,Pac-12,13,1,1,1.0,0,0.1,7,128,18.3,0,9.8,8,129,16.1,0,,ricky-pearsall-1
1437,Solomon Enis*,Utah,Pac-12,14,1,1,1.0,0,0.1,14,158,11.3,0,11.3,15,159,10.6,0,,solomon-enis-1
1438,Spencer Petras*,Iowa,Big Ten,3,1,1,1.0,1,0.3,0,0,,0,0.0,1,1,1.0,1,,spencer-petras-1
1439,Tevita Ika*,BYU,Ind,3,3,1,0.3,0,0.3,3,28,9.3,0,9.3,6,29,4.8,0,,tevita-ika-1
1440,Trenell Troutman*,Louisville,ACC,13,1,1,1.0,0,0.1,0,0,,0,0.0,1,1,1.0,0,,trenell-troutman-1
1441,William Brown*,SMU,American,1,1,1,1.0,0,1.0,0,0,,0,0.0,1,1,1.0,0,,william-brown-2
1442,Xavier Thomas*,Clemson,ACC,12,1,1,1.0,0,0.1,0,0,,0,0.0,1,1,1.0,0,,xavier-thomas-1
1443,Yusuf Ali,Middle Tennessee State,CUSA,11,1,1,1.0,0,0.1,19,190,10.0,0,17.3,20,191,9.6,0,,yusuf-ali-1
1444,Andrew Parchment,Kansas,Big 12,12,1,0,0.0,0,0.0,65,831,12.8,7,69.3,66,831,12.6,7,,andrew-parchment-1
1445,Aubry Payne*,Georgia State,Sun Belt,12,1,0,0.0,0,0.0,13,204,15.7,6,17.0,14,204,14.6,6,,aubry-payne-1
1446,BJ Busbee*,San Diego State,MWC,12,2,0,0.0,0,0.0,13,109,8.4,0,9.1,15,109,7.3,0,,bj-busbee-1
1447,Blake Hayes*,Illinois,Big Ten,13,1,0,0.0,0,0.0,0,0,,0,0.0,1,0,0.0,0,,blake-hayes-1
1448,Brevin Jordan*,Miami (FL),ACC,11,1,0,0.0,0,0.0,35,495,14.1,2,45.0,36,495,13.8,2,,brevin-jordan-1
1449,Chazz Surratt*,North Carolina,ACC,13,1,0,0.0,0,0.0,0,0,,0,0.0,1,0,0.0,0,,chazz-surratt-1
1450,Collin Hill,Colorado State,MWC,3,10,0,0.0,1,0.0,0,0,,0,0.0,10,0,0.0,1,,collin-hill-1
1451,Coltin Clark*,Arkansas State,Sun Belt,2,1,0,0.0,0,0.0,0,0,,0,0.0,1,0,0.0,0,,coltin-clark-1
1452,Dane Kinamon*,Air Force,MWC,10,1,0,0.0,0,0.0,0,0,,0,0.0,1,0,0.0,0,,dane-kinamon-1
1453,Daquon Godfrey*,UAB,CUSA,2,1,0,0.0,0,0.0,0,0,,0,0.0,1,0,0.0,0,,daquon-godfrey-1
1454,Jahan Dotson*,Penn State,Big Ten,13,2,0,0.0,0,0.0,27,488,18.1,5,37.5,29,488,16.8,5,,jahan-dotson-1
1455,Kyle Beaudry,Nevada-Las Vegas,MWC,12,1,0,0.0,0,0.0,0,0,,0,0.0,1,0,0.0,0,,kyle-beaudry-1
1456,Melquise Stovall*,Hawaii,MWC,6,1,0,0.0,0,0.0,18,248,13.8,4,41.3,19,248,13.1,4,,melquise-stovall-1
1457,Monte Pottebaum*,Iowa,Big Ten,11,1,0,0.0,0,0.0,0,0,,0,0.0,1,0,0.0,0,,monte-pottebaum-1
1458,Oakley Lavallii*,Central Michigan,MAC,13,1,0,0.0,0,0.0,1,6,6.0,0,0.5,2,6,3.0,0,,oakley-lavallii-1
1459,Rashee Rice*,SMU,American,10,1,0,0.0,0,0.0,25,403,16.1,1,40.3,26,403,15.5,1,,rashee-rice-1
1460,Sylvester Mayers*,Clemson,ACC,1,1,0,0.0,0,0.0,0,0,,0,0.0,1,0,0.0,0,,sylvester-mayers-1
1461,Thaddeus Cornick*,Central Michigan,MAC,4,3,0,0.0,0,0.0,0,0,,0,0.0,3,0,0.0,0,,thaddeus-cornick-1
1462,Theo Day*,Michigan State,Big Ten,2,1,0,0.0,0,0.0,0,0,,0,0.0,1,0,0.0,0,,theo-day-1
1463,Turner Pallissard*,Iowa,Big Ten,4,1,0,0.0,0,0.0,0,0,,0,0.0,1,0,0.0,0,,turner-pallissard-1
1464,Tylan Wallace*,Oklahoma State,Big 12,9,1,0,0.0,0,0.0,53,903,17.0,8,100.3,54,903,16.7,8,,tylan-wallace-1
1465,Tyrese Johnson,Middle Tennessee State,CUSA,12,1,0,0.0,0,0.0,3,37,12.3,0,3.1,4,37,9.3,0,,tyrese-johnson-1
1466,Xavier White,Texas Tech,Big 12,4,1,0,0.0,0,0.0,10,159,15.9,1,39.8,11,159,14.5,1,,xavier-white-1
1467,Zach Calzada*,Texas A&M,SEC,3,5,0,0.0,0,0.0,0,0,,0,0.0,5,0,0.0,0,,zach-calzada-1
1468,Zane Pope,Fresno State,MWC,12,1,0,0.0,0,0.0,47,529,11.3,1,44.1,48,529,11.0,1,,zane-pope-1
1469,Andrew Bunch,Nebraska,Big Ten,2,2,-1,-0.5,0,-0.5,0,0,,0,0.0,2,-1,-0.5,0,,andrew-bunch-2
1470,Antwan Dixon*,Kent State,MAC,13,5,-1,-0.2,0,-0.1,34,333,9.8,1,25.6,39,332,8.5,1,,antwan-dixon-2
1471,Austin Watkins*,UAB,CUSA,14,1,-1,-1.0,0,-0.1,57,1092,19.2,6,78.0,58,1091,18.8,6,,austin-watkins-1
1472,Brayden Willis*,Oklahoma,Big 12,14,2,-1,-0.5,0,-0.1,11,168,15.3,3,12.0,13,167,12.8,3,,brayden-willis-1
1473,Chris Herron*,Kansas State,Big 12,3,1,-1,-1.0,0,-0.3,0,0,,0,0.0,1,-1,-1.0,0,,chris-herron-1
1474,Clevan Thomas*,Kentucky,SEC,13,3,-1,-0.3,0,-0.1,11,99,9.0,1,7.6,14,98,7.0,1,,clevan-thomas-2
1475,Elijah Moore,Ole Miss,SEC,12,4,-1,-0.3,0,-0.1,67,850,12.7,6,70.8,71,849,12.0,6,,elijah-moore-1
1476,Hassan Beydoun*,Eastern Michigan,MAC,13,2,-1,-0.5,0,-0.1,30,349,11.6,1,26.8,32,348,10.9,1,,hassan-beydoun-1
1477,Ian Mclver*,Oklahoma,Big 12,5,1,-1,-1.0,0,-0.2,0,0,,0,0.0,1,-1,-1.0,0,,ian-mclver-1
1478,Jalen McCleskey*,Tulane,American,13,1,-1,-1.0,0,-0.1,37,581,15.7,4,44.7,38,580,15.3,4,,jalen-mccleskey-1
1479,Jessie Britt,Massachusetts,Ind,5,1,-1,-1.0,0,-0.2,11,108,9.8,0,21.6,12,107,8.9,0,,jessie-britt-1
1480,Jordan Wayne-Prather,Bowling Green,MAC,12,3,-1,-0.3,0,-0.1,9,57,6.3,0,4.8,12,56,4.7,0,,jordan-wayne-prather-1
1481,Michael Love,Northern Illinois,MAC,12,1,-1,-1.0,0,-0.1,13,107,8.2,0,8.9,14,106,7.6,0,,michael-love-3
1482,Nathan Priestley*,Georgia,SEC,2,1,-1,-1.0,0,-0.5,0,0,,0,0.0,1,-1,-1.0,0,,nathan-priestley-1
1483,OrTre Smith,South Carolina,SEC,9,1,-1,-1.0,0,-0.1,9,69,7.7,1,7.7,10,68,6.8,1,,ortre-smith-1
1484,Romeo Doubs*,Nevada,MWC,11,1,-1,-1.0,0,-0.1,44,649,14.8,4,59.0,45,648,14.4,4,,romeo-doubs-1
1485,Ta'Quan Roberson*,Penn State,Big Ten,1,1,-1,-1.0,0,-1.0,0,0,,0,0.0,1,-1,-1.0,0,,taquan-roberson-1
1486,Tayvian Cunningham,Arizona,Pac-12,12,1,-1,-1.0,0,-0.1,35,383,10.9,2,31.9,36,382,10.6,2,,tayvian-cunningham-1
1487,Trevor Hohlt,Ball State,MAC,10,1,-1,-1.0,0,-0.1,1,5,5.0,0,0.5,2,4,2.0,0,,trevor-hohlt-1
1488,Tyler Lytle,Colorado,Pac-12,3,1,-1,-1.0,0,-0.3,0,0,,0,0.0,1,-1,-1.0,0,,tyler-lytle-1
1489,Ben Lennon*,Utah,Pac-12,14,1,-2,-2.0,0,-0.1,0,0,,0,0.0,1,-2,-2.0,0,,ben-lennon-1
1490,Brandon Heicklen*,San Diego State,MWC,13,1,-2,-2.0,0,-0.2,0,0,,0,0.0,1,-2,-2.0,0,,brandon-heicklen-1
1491,Jackson Gibbs*,Appalachian State,Sun Belt,2,2,-2,-1.0,0,-1.0,0,0,,0,0.0,2,-2,-1.0,0,,jackson-gibbs-2
1492,Jai'ave Magalei*,Louisiana,Sun Belt,6,2,-2,-1.0,0,-0.3,0,0,,0,0.0,2,-2,-1.0,0,,jaiave-magalei-1
1493,Jeremiah Hawkins*,California,Pac-12,7,1,-2,-2.0,0,-0.3,7,66,9.4,0,9.4,8,64,8.0,0,,jeremiah-hawkins-1
1494,Logan Ammons*,Tulane,American,2,1,-2,-2.0,0,-1.0,0,0,,0,0.0,1,-2,-2.0,0,,logan-ammons-1
1495,Robby Rowell*,California,Pac-12,2,2,-2,-1.0,0,-1.0,0,0,,0,0.0,2,-2,-1.0,0,,robby-rowell-1
1496,Taulia Tagovailoa*,Alabama,SEC,5,1,-2,-2.0,0,-0.4,0,0,,0,0.0,1,-2,-2.0,0,,taulia-tagovailoa-1
1497,Tim Jones*,Southern Mississippi,CUSA,13,1,-2,-2.0,0,-0.2,73,902,12.4,3,69.4,74,900,12.2,3,,tim-jones-8
1498,Tyger Goslin*,Navy,American,1,4,-2,-0.5,0,-2.0,0,0,,0,0.0,4,-2,-0.5,0,,tyger-goslin-1
1499,Zidane Thomas*,San Diego State,MWC,1,3,-2,-0.7,0,-2.0,0,0,,0,0.0,3,-2,-0.7,0,,zidane-thomas-1
1500,Andrew Zuckerman*,Tulane,American,2,1,-3,-3.0,0,-1.5,0,0,,0,0.0,1,-3,-3.0,0,,andrew-zuckerman-1
1501,Cade Sutherland,South Alabama,Sun Belt,12,1,-3,-3.0,0,-0.3,10,164,16.4,0,13.7,11,161,14.6,0,,cade-sutherland-1
1502,Cordale Grundy,UTSA,CUSA,2,3,-3,-1.0,0,-1.5,0,0,,0,0.0,3,-3,-1.0,0,,cordale-grundy-1
1503,David Moore*,Central Michigan,MAC,6,22,-3,-0.1,1,-0.5,0,0,,0,0.0,22,-3,-0.1,1,,david-moore-5
1504,Hutch White,Texas State,Sun Belt,12,3,-3,-1.0,0,-0.3,67,618,9.2,2,51.5,70,615,8.8,2,,hutch-white-1
1505,Jared Wayne*,Pitt,ACC,8,1,-3,-3.0,0,-0.4,18,261,14.5,1,32.6,19,258,13.6,1,,jared-wayne-1
1506,Joe Critchlow*,BYU,Ind,3,2,-3,-1.5,0,-1.0,0,0,,0,0.0,2,-3,-1.5,0,,joe-critchlow-1
1507,Justin Agner*,Florida Atlantic,CUSA,3,2,-3,-1.5,0,-1.0,0,0,,0,0.0,2,-3,-1.5,0,,justin-agner-1
1508,Rhett Rodriguez,Arizona,Pac-12,1,1,-3,-3.0,0,-3.0,0,0,,0,0.0,1,-3,-3.0,0,,rhett-rodriguez-1
1509,Rocky Lombardi*,Michigan State,Big Ten,8,4,-3,-0.8,0,-0.4,0,0,,0,0.0,4,-3,-0.8,0,,rocky-lombardi-1
1510,Taylor Powell,Missouri,SEC,6,6,-3,-0.5,0,-0.5,0,0,,0,0.0,6,-3,-0.5,0,,taylor-powell-1
1511,Trent Wessel*,Florida Atlantic,CUSA,1,2,-3,-1.5,0,-3.0,0,0,,0,0.0,2,-3,-1.5,0,,trent-wessel-1
1512,Zachar Larrier*,Air Force,MWC,1,1,-3,-3.0,0,-3.0,0,0,,0,0.0,1,-3,-3.0,0,,zachar-larrier-1
1513,Aaron Mathews*,Pitt,ACC,13,1,-4,-4.0,0,-0.3,13,220,16.9,1,16.9,14,216,15.4,1,,aaron-mathews-1
1514,Hunter Bryant*,Washington,Pac-12,12,2,-4,-2.0,0,-0.3,52,825,15.9,3,68.8,54,821,15.2,3,,hunter-bryant-2
1515,Jake Oldroyd*,BYU,Ind,13,1,-4,-4.0,0,-0.3,0,0,,0,0.0,1,-4,-4.0,0,,jake-oldroyd-1
1516,Mark Richardson,Texas Tech,Big 12,12,2,-4,-2.0,0,-0.3,0,0,,0,0.0,2,-4,-2.0,0,,mark-richardson-2
1517,Peyton Hendershot*,Indiana,Big Ten,13,1,-4,-4.0,0,-0.3,52,622,12.0,4,47.8,53,618,11.7,4,,peyton-hendershot-1
1518,Sheldon Jones,UTSA,CUSA,12,1,-4,-4.0,0,-0.3,31,259,8.4,0,21.6,32,255,8.0,0,,sheldon-jones-1
1519,T.J. Simmons,West Virginia,Big 12,10,1,-4,-4.0,0,-0.4,35,455,13.0,4,45.5,36,451,12.5,4,,tj-simmons-4
1520,Trace Clopton*,Southern Mississippi,CUSA,12,1,-4,-4.0,0,-0.3,0,0,,0,0.0,1,-4,-4.0,0,,trace-clopton-1
1521,Trevon Grimes*,Florida,SEC,13,1,-4,-4.0,0,-0.3,33,491,14.9,3,37.8,34,487,14.3,3,,trevon-grimes-1
1522,Alex Harris*,UCF,American,10,1,-5,-5.0,0,-0.5,4,44,11.0,1,4.4,5,39,7.8,1,,alex-harris-2
1523,Brandt Hughes,New Mexico,MWC,1,1,-5,-5.0,0,-5.0,0,0,,0,0.0,1,-5,-5.0,0,,brandt-hughes-1
1524,Brennon Dingle,Massachusetts,Ind,12,2,-5,-2.5,0,-0.4,23,239,10.4,1,19.9,25,234,9.4,1,,brennon-dingle-1
1525,Cameron Dollar*,Charlotte,CUSA,13,1,-5,-5.0,0,-0.4,41,599,14.6,2,46.1,42,594,14.1,2,,cameron-dollar-1
1526,Greg Latushko,Coastal Carolina,Sun Belt,10,1,-5,-5.0,0,-0.5,0,0,,0,0.0,1,-5,-5.0,0,,greg-latushko-1
1527,Jacob Gasser,Nevada-Las Vegas,MWC,11,1,-5,-5.0,0,-0.5,10,55,5.5,0,5.0,11,50,4.5,0,,jacob-gasser-1
1528,Jacob Sirmon*,Washington,Pac-12,5,2,-5,-2.5,0,-1.0,0,0,,0,0.0,2,-5,-2.5,0,,jacob-sirmon-1
1529,Jake Bentley,South Carolina,SEC,1,6,-5,-0.8,0,-5.0,0,0,,0,0.0,6,-5,-0.8,0,,jake-bentley-2
1530,Joey Yellen*,Arizona State,Pac-12,1,1,-5,-5.0,0,-5.0,0,0,,0,0.0,1,-5,-5.0,0,,joey-yellen-1
1531,Josh Turner*,Florida International,CUSA,10,1,-5,-5.0,0,-0.5,0,0,,0,0.0,1,-5,-5.0,0,,josh-turner-2
1532,Lindell Stone*,Virginia,ACC,2,1,-5,-5.0,0,-2.5,0,0,,0,0.0,1,-5,-5.0,0,,lindell-stone-1
1533,Matt Valecce*,Boston College,ACC,4,2,-5,-2.5,0,-1.3,0,0,,0,0.0,2,-5,-2.5,0,,matt-valecce-1
1534,Matt Valecce*,Boston College,ACC,6,2,-5,-2.5,0,-0.8,0,0,,0,0.0,2,-5,-2.5,0,,matt-valecce-2
1535,Michael Shuster*,Penn State,Big Ten,1,1,-5,-5.0,0,-5.0,0,0,,0,0.0,1,-5,-5.0,0,,michael-shuster-1
1536,Quavon Beckford,Houston,American,3,1,-5,-5.0,0,-1.7,0,0,,0,0.0,1,-5,-5.0,0,,quavon-beckford-1
1537,Ricky Walker III*,California,Pac-12,11,1,-5,-5.0,0,-0.5,2,30,15.0,0,2.7,3,25,8.3,0,,ricky-walker-iii-1
1538,R.J. Sneed*,Baylor,Big 12,14,1,-5,-5.0,0,-0.4,42,437,10.4,3,31.2,43,432,10.0,3,,rj-sneed-1
1539,Robbie Kelley,Akron,MAC,8,7,-5,-0.7,0,-0.6,0,0,,0,0.0,7,-5,-0.7,0,,robbie-kelley-1
1540,Shedro Louis*,Liberty,Ind,11,1,-5,-5.0,0,-0.5,4,33,8.3,0,3.0,5,28,5.6,0,,shedro-louis-1
1541,Talik Keaton*,Marshall,CUSA,12,1,-5,-5.0,0,-0.4,9,140,15.6,1,11.7,10,135,13.5,1,,talik-keaton-1
1542,Berkeley Holman,Northwestern,Big Ten,12,1,-6,-6.0,0,-0.5,9,124,13.8,0,10.3,10,118,11.8,0,,berkeley-holman-1
1543,Carson Strong*,Nevada,MWC,10,54,-6,-0.1,0,-0.6,0,0,,0,0.0,54,-6,-0.1,0,,carson-strong-1
1544,Daniel Bellinger*,San Diego State,MWC,13,1,-6,-6.0,0,-0.5,15,201,13.4,3,15.5,16,195,12.2,3,,daniel-bellinger-1
1545,Darius Stubbs*,Georgia State,Sun Belt,2,9,-6,-0.7,0,-3.0,0,0,,0,0.0,9,-6,-0.7,0,,darius-stubbs-1
1546,Dominic Stampley*,Illinois,Big Ten,9,3,-6,-2.0,0,-0.7,9,101,11.2,0,11.2,12,95,7.9,0,,dominic-stampley-1
1547,Gunnar Hoak*,Ohio State,Big Ten,4,4,-6,-1.5,0,-1.5,0,0,,0,0.0,4,-6,-1.5,0,,gunnar-hoak-1
1548,Jordan Weeks,UTSA,CUSA,3,10,-6,-0.6,0,-2.0,0,0,,0,0.0,10,-6,-0.6,0,,jordan-weeks-1
1549,JT Daniels*,USC,Pac-12,1,3,-6,-2.0,0,-6.0,0,0,,0,0.0,3,-6,-2.0,0,,jt-daniels-1
1550,Julian Ortega-Jones,Bowling Green,MAC,9,1,-6,-6.0,0,-0.7,20,298,14.9,0,33.1,21,292,13.9,0,,julian-ortega-jones-1
1551,Julian Ortega-Jones,Bowling Green,MAC,11,1,-6,-6.0,0,-0.5,20,298,14.9,0,27.1,21,292,13.9,0,,julian-ortega-jones-2
1552,Kieston Roach,Texas State,Sun Belt,1,1,-6,-6.0,0,-6.0,0,0,,0,0.0,1,-6,-6.0,0,,kieston-roach-1
1553,Matt Landers*,Georgia,SEC,12,1,-6,-6.0,0,-0.5,10,105,10.5,1,8.8,11,99,9.0,1,,matt-landers-1
1554,Rex Culpepper,Syracuse,ACC,2,1,-6,-6.0,0,-3.0,0,0,,0,0.0,1,-6,-6.0,0,,rex-culpepper-1
1555,Artur Sitkowski,Rutgers,Big Ten,3,8,-7,-0.9,0,-2.3,0,0,,0,0.0,8,-7,-0.9,0,,artur-sitkowski-1
1556,Carter Bradley,Toledo,MAC,7,25,-7,-0.3,1,-1.0,0,0,,0,0.0,25,-7,-0.3,1,,carter-bradley-1
1557,Donovan Peoples-Jones*,Michigan,Big Ten,11,2,-7,-3.5,0,-0.6,34,438,12.9,6,39.8,36,431,12.0,6,,donovan-peoples-jones-1
1558,Gavin Hardison,UTEP,CUSA,2,14,-7,-0.5,0,-3.5,0,0,,0,0.0,14,-7,-0.5,0,,gavin-hardison-1
1559,Landon Brown*,Liberty,Ind,13,1,-7,-7.0,0,-0.5,0,0,,0,0.0,1,-7,-7.0,0,,landon-brown-1
1560,Logan Bonner*,Arkansas State,Sun Belt,5,20,-7,-0.4,1,-1.4,1,37,37.0,0,7.4,21,30,1.4,1,,logan-bonner-1
1561,Rayshad Lewis,Maryland,Big Ten,10,1,-7,-7.0,0,-0.7,3,13,4.3,0,1.3,4,6,1.5,0,,rayshad-lewis-2
1562,Bailey Hockman,North Carolina State,ACC,7,16,-8,-0.5,0,-1.1,0,0,,0,0.0,16,-8,-0.5,0,,bailey-hockman-1
1563,Donavan Hale*,Indiana,Big Ten,11,2,-8,-4.0,0,-0.7,22,373,17.0,3,33.9,24,365,15.2,3,,donavan-hale-1
1564,Evan Marshman,Rice,CUSA,1,6,-8,-1.3,0,-8.0,0,0,,0,0.0,6,-8,-1.3,0,,evan-marshman-1
1565,Jack Allison,West Virginia,Big 12,2,4,-8,-2.0,0,-4.0,0,0,,0,0.0,4,-8,-2.0,0,,jack-allison-1
1566,Justin Uahinui*,Hawaii,MWC,2,1,-8,-8.0,0,-4.0,0,0,,0,0.0,1,-8,-8.0,0,,justin-uahinui-1
1567,Logan Holgorsen,Houston,American,7,4,-8,-2.0,0,-1.1,0,0,,0,0.0,4,-8,-2.0,0,,logan-holgorsen-1
1568,Matt Naranjo,Bowling Green,MAC,12,1,-8,-8.0,0,-0.7,0,0,,0,0.0,1,-8,-8.0,0,,matt-naranjo-1
1569,Aidan O'Connell,Purdue,Big Ten,6,15,-9,-0.6,0,-1.5,0,0,,0,0.0,15,-9,-0.6,0,,aidan-oconnell-1
1570,Dadrian Taylor,UTSA,CUSA,10,1,-9,-9.0,0,-0.9,0,0,,0,0.0,1,-9,-9.0,0,,dadrian-taylor-1
1571,Daewood Davis*,Oregon,Pac-12,13,1,-9,-9.0,0,-0.7,9,89,9.9,1,6.8,10,80,8.0,1,,daewood-davis-1
1572,Dominic Christian*,Nevada,MWC,12,1,-9,-9.0,0,-0.8,35,321,9.2,2,26.8,36,312,8.7,2,,dominic-christian-1
1573,Hamish McClure*,Nevada,MWC,2,2,-9,-4.5,0,-4.5,0,0,,0,0.0,2,-9,-4.5,0,,hamish-mcclure-1
1574,Jacob Zeno*,Baylor,Big 12,3,8,-9,-1.1,1,-3.0,0,0,,0,0.0,8,-9,-1.1,1,,jacob-zeno-1
1575,Jon Runyan*,Michigan,Big Ten,12,1,-9,-9.0,0,-0.8,0,0,,0,0.0,1,-9,-9.0,0,,jon-runyan-1
1576,Tyler Gillkin,Northwestern,Big Ten,11,1,-9,-9.0,0,-0.8,0,0,,0,0.0,1,-9,-9.0,0,,tyler-gillkin-1
1577,Chris Chugunov*,Ohio State,Big Ten,10,4,-10,-2.5,0,-1.0,0,0,,0,0.0,4,-10,-2.5,0,,chris-chugunov-1
1578,Hayden Wolff,Old Dominion,CUSA,3,12,-10,-0.8,0,-3.3,0,0,,0,0.0,12,-10,-0.8,0,,hayden-wolff-1
1579,Leki Nunn,San Jose State,MWC,2,1,-10,-10.0,0,-5.0,0,0,,0,0.0,1,-10,-10.0,0,,leki-nunn-1
1580,Mike Shinsky,Maryland,Big Ten,12,1,-10,-10.0,0,-0.8,0,0,,0,0.0,1,-10,-10.0,0,,mike-shinsky-1
1581,Tayvone Bowers*,Wake Forest,ACC,4,3,-10,-3.3,0,-2.5,0,0,,0,0.0,3,-10,-3.3,0,,tayvone-bowers-1
1582,Westin Elliott*,Louisiana Tech,CUSA,6,2,-10,-5.0,0,-1.7,0,0,,0,0.0,2,-10,-5.0,0,,westin-elliott-1
1583,AJ Mayer*,Miami (OH),MAC,3,3,-11,-3.7,0,-3.7,0,0,,0,0.0,3,-11,-3.7,0,,aj-mayer-1
1584,Peyton Theisler,New Mexico State,Ind,12,1,-11,-11.0,0,-0.9,0,0,,0,0.0,1,-11,-11.0,0,,peyton-theisler-1
1585,Sawyer Smith*,Kentucky,SEC,9,24,-11,-0.5,1,-1.2,0,0,,0,0.0,24,-11,-0.5,1,,sawyer-smith-1
1586,Brady Farlow*,Louisiana Tech,CUSA,13,1,-12,-12.0,0,-0.9,0,0,,0,0.0,1,-12,-12.0,0,,brady-farlow-1
1587,D.J. Stubbs*,Liberty,Ind,13,1,-12,-12.0,0,-0.9,32,401,12.5,3,30.8,33,389,11.8,3,,dj-stubbs-1
1588,Jahcour Pearson*,Western Kentucky,CUSA,13,5,-12,-2.4,0,-0.9,76,804,10.6,7,61.8,81,792,9.8,7,,jahcour-pearson-1
1589,Jake Fromm*,Georgia,SEC,14,38,-12,-0.3,0,-0.9,0,0,,0,0.0,38,-12,-0.3,0,,jake-fromm-1
1590,Jake Julien*,Eastern Michigan,MAC,13,2,-12,-6.0,0,-0.9,0,0,,0,0.0,2,-12,-6.0,0,,jake-julien-1
1591,Matt Fink*,USC,Pac-12,8,12,-12,-1.0,1,-1.5,0,0,,0,0.0,12,-12,-1.0,1,,matt-fink-1
1592,Conrad Rowley,Northwestern,Big Ten,2,1,-13,-13.0,0,-6.5,0,0,,0,0.0,1,-13,-13.0,0,,conrad-rowley-1
1593,Darrell Stewart Jr.*,Michigan State,Big Ten,9,2,-13,-6.5,0,-1.4,49,697,14.2,4,77.4,51,684,13.4,4,,darrell-stewart-jr-1
1594,McLane Carter,Rutgers,Big Ten,2,2,-13,-6.5,0,-6.5,0,0,,0,0.0,2,-13,-6.5,0,,mclane-carter-1
1595,Anthony Lotti*,Wisconsin,Big Ten,12,2,-14,-7.0,0,-1.2,0,0,,0,0.0,2,-14,-7.0,0,,anthony-lotti-1
1596,Preston Hutchinson*,Eastern Michigan,MAC,8,24,-14,-0.6,2,-1.8,0,0,,0,0.0,24,-14,-0.6,2,,preston-hutchinson-1
1597,Quadry Jones*,UCF,American,3,5,-15,-3.0,0,-5.0,0,0,,0,0.0,5,-15,-3.0,0,,quadry-jones-1
1598,Ky'Jon Tyler,Coastal Carolina,Sun Belt,9,4,-16,-4.0,0,-1.8,23,203,8.8,1,22.6,27,187,6.9,1,,kyjon-tyler-1
1599,Matt Ference,Northern Illinois,MAC,12,3,-16,-5.3,0,-1.3,0,0,,0,0.0,3,-16,-5.3,0,,matt-ference-1
1600,Nick Starkel,Arkansas,SEC,8,6,-16,-2.7,0,-2.0,0,0,,0,0.0,6,-16,-2.7,0,,nick-starkel-1
1601,Tyler Desue,Maryland,Big Ten,6,4,-18,-4.5,1,-3.0,0,0,,0,0.0,4,-18,-4.5,1,,tyler-desue-1
1602,Ty Perine*,Alabama,SEC,6,1,-19,-19.0,0,-3.2,0,0,,0,0.0,1,-19,-19.0,0,,ty-perine-1
1603,Tyler Vander Waal*,Wyoming,MWC,8,27,-19,-0.7,4,-2.4,1,-5,-5.0,0,-0.6,28,-24,-0.9,4,,tyler-vander-waal-1
1604,Anthony Gordon*,Washington State,Pac-12,13,51,-20,-0.4,0,-1.5,0,0,,0,0.0,51,-20,-0.4,0,,anthony-gordon-2
1605,Patrick O'Brien,Colorado State,MWC,11,63,-21,-0.3,2,-1.9,0,0,,0,0.0,63,-21,-0.3,2,,patrick-obrien-1
1606,Will Spiers*,Clemson,ACC,15,1,-21,-21.0,0,-1.4,0,0,,0,0.0,1,-21,-21.0,0,,will-spiers-1
1607,Seamus O'Kelly,Texas State,Sun Belt,12,1,-25,-25.0,0,-2.1,0,0,,0,0.0,1,-25,-25.0,0,,seamus-okelly-1
1608,Jack West,Stanford,Pac-12,2,12,-28,-2.3,0,-14.0,0,0,,0,0.0,12,-28,-2.3,0,,jack-west-4
1609,Wiley Green,Rice,CUSA,7,27,-29,-1.1,0,-4.1,0,0,,0,0.0,27,-29,-1.1,0,,wiley-green-1
1610,Deuce Wallace,Vanderbilt,SEC,8,15,-31,-2.1,0,-3.9,0,0,,0,0.0,15,-31,-2.1,0,,deuce-wallace-2
1611,Mike Beaudry,Connecticut,American,6,21,-32,-1.5,1,-5.3,0,0,,0,0.0,21,-32,-1.5,1,,mike-beaudry-1
1612,Geraud Sanders*,Air Force,MWC,13,2,-36,-18.0,0,-2.8,30,746,24.9,7,57.4,32,710,22.2,7,,geraud-sanders-1
1613,Tommy Heatherly*,Florida International,CUSA,13,2,-36,-18.0,0,-2.8,0,0,,0,0.0,2,-36,-18.0,0,,tommy-heatherly-1
1614,Quinten Dormady*,Central Michigan,MAC,10,35,-39,-1.1,0,-3.9,0,0,,0,0.0,35,-39,-1.1,0,,quinten-dormady-1
1615,James Morgan*,Florida International,CUSA,13,32,-40,-1.3,2,-3.1,0,0,,0,0.0,32,-40,-1.3,2,,james-morgan-1
1616,Jarret Doege,West Virginia,Big 12,4,11,-41,-3.7,0,-10.3,0,0,,0,0.0,11,-41,-3.7,0,,jarret-doege-1
1617,Spencer Brasch*,California,Pac-12,2,7,-42,-6.0,0,-21.0,0,0,,0,0.0,7,-42,-6.0,0,,spencer-brasch-1
1618,Kenyon Oblad,Nevada-Las Vegas,MWC,11,45,-43,-1.0,1,-3.9,0,0,,0,0.0,45,-43,-1.0,1,,kenyon-oblad-1
1619,Matt Robinson*,Illinois,Big Ten,8,30,-45,-1.5,1,-5.6,0,0,,0,0.0,30,-45,-1.5,1,,matt-robinson-6
1620,Jack Zergiotis,Connecticut,American,10,41,-46,-1.1,0,-4.6,1,-1,-1.0,0,-0.1,42,-47,-1.1,0,,jack-zergiotis-1
1621,Gresch Jensen,Texas State,Sun Belt,7,28,-49,-1.8,2,-7.0,0,0,,0,0.0,28,-49,-1.8,2,,gresch-jensen-1
1622,Josh Jackson,Maryland,Big Ten,10,53,-53,-1.0,0,-5.3,0,0,,0,0.0,53,-53,-1.0,0,,josh-jackson-3
1623,Ryan Hilinski,South Carolina,SEC,11,33,-55,-1.7,1,-5.0,2,-14,-7.0,0,-1.3,35,-69,-2.0,1,,ryan-hilinski-1
1624,Kedon Slovis*,USC,Pac-12,12,45,-57,-1.3,0,-4.8,0,0,,0,0.0,45,-57,-1.3,0,,kedon-slovis-1
1625,Tanner Morgan*,Minnesota,Big Ten,13,61,-57,-0.9,1,-4.4,0,0,,0,0.0,61,-57,-0.9,1,,tanner-morgan-2
1626,Chris Robison*,Florida Atlantic,CUSA,14,84,-60,-0.7,2,-4.3,0,0,,0,0.0,84,-60,-0.7,2,,chris-robison-1
1627,Anthony Russo*,Temple,American,13,35,-64,-1.8,2,-4.9,0,0,,0,0.0,35,-64,-1.8,2,,anthony-russo-3
1628,Jarren Williams*,Miami (FL),ACC,12,67,-68,-1.0,0,-5.7,0,0,,0,0.0,67,-68,-1.0,0,,jarren-williams-1
1629,Jacob Eason*,Washington,Pac-12,13,46,-69,-1.5,1,-5.3,0,5,,0,0.4,46,-64,-1.4,1,,jacob-eason-1
1630,Alex Hornibrook*,Florida State,ACC,5,29,-71,-2.4,0,-14.2,1,6,6.0,0,1.2,30,-65,-2.2,0,,alex-hornibrook-1
1631,Brady White*,Memphis,American,14,61,-71,-1.2,4,-5.1,1,25,25.0,0,1.8,62,-46,-0.7,4,,brady-white-1
1632,Zach Gibson,Akron,MAC,4,14,-72,-5.1,0,-18.0,0,0,,0,0.0,14,-72,-5.1,0,,zach-gibson-1
1633,Andrew Brito,Massachusetts,Ind,10,34,-86,-2.5,0,-8.6,0,0,,0,0.0,34,-86,-2.5,0,,andrew-brito-1
1634,Jake Luton,Oregon State,Pac-12,11,44,-87,-2.0,1,-7.9,0,0,,0,0.0,44,-87,-2.0,1,,jake-luton-1
1635,Josh Love,San Jose State,MWC,12,25,-88,-3.5,3,-7.3,0,0,,0,0.0,25,-88,-3.5,3,,josh-love-1
1636,Zach Smith,Tulsa,American,12,75,-96,-1.3,0,-8.0,0,0,,0,0.0,75,-96,-1.3,0,,zach-smith-6
1637,Mason Fine,North Texas,CUSA,12,55,-98,-1.8,2,-8.2,0,0,,0,0.0,55,-98,-1.8,2,,mason-fine-1
1638,Ross Bowers,Northern Illinois,MAC,9,34,-111,-3.3,1,-12.3,0,0,,0,0.0,34,-111,-3.3,1,,ross-bowers-1
1639,Stephen Calvert*,Liberty,Ind,13,40,-151,-3.8,0,-11.6,0,0,,0,0.0,40,-151,-3.8,0,,stephen-calvert-1