Rk,Player,Team,Conf,G,Att,Yds,Y/A,TD,Y/G,Rec,Yds,Y/R,TD,Y/G,Plays,Yds,Avg,TD,Awards,-9999
1,Ollie Gordon*,Oklahoma State,Big 12,14,285,1732,6.1,21,123.7,39,330,8.5,1,23.6,324,2062,6.4,22,H-7AA,ollie-gordon-1
2,Kimani Vidal*,Troy,Sun Belt,14,297,1661,5.6,14,118.6,18,201,11.2,1,14.4,315,1862,5.9,15,,kimani-vidal-1
3,Cody Schrader*,Missouri,SEC,13,276,1627,5.9,14,125.2,22,191,8.7,0,14.7,298,1818,6.1,14,H-8AA,cody-schrader-1
4,Tahj Brooks*,Texas Tech,Big 12,13,290,1538,5.3,10,118.3,29,72,2.5,0,5.5,319,1610,5.0,10,,tahj-brooks-1
5,Omarion Hampton*,North Carolina,ACC,13,253,1504,5.9,15,115.7,29,222,7.7,1,17.1,282,1726,6.1,16,,omarion-hampton-1
6,R.J. Harvey*,UCF,Big 12,13,226,1416,6.3,16,108.9,19,238,12.5,1,18.3,245,1654,6.8,17,,rj-harvey-1
7,Quinton Cooley*,Liberty,CUSA,14,221,1401,6.3,16,100.1,6,43,7.2,0,3.1,227,1444,6.4,16,,quinton-cooley-1
8,Peny Boone*,Toledo,MAC,13,194,1400,7.2,15,107.7,15,219,14.6,1,16.8,209,1619,7.7,16,,peny-boone-1
9,Makhi Hughes*,Tulane,American,14,258,1378,5.3,7,98.4,11,67,6.1,0,4.8,269,1445,5.4,7,,makhi-hughes-1
10,Marcus Carroll*,Georgia State,Sun Belt,12,274,1350,4.9,13,112.5,23,234,10.2,0,19.5,297,1584,5.3,13,,marcus-carroll-1
11,Ashton Jeanty*,Boise State,MWC,12,220,1347,6.1,14,112.3,43,569,13.2,5,47.4,263,1916,7.3,19,,ashton-jeanty-1
12,Audric Estime*,Notre Dame,Ind,12,210,1341,6.4,18,111.8,17,142,8.4,0,11.8,227,1483,6.5,18,,audric-estime-1
13,Ismail Mahdi*,Texas State,Sun Belt,13,223,1331,6.0,10,102.4,20,275,13.8,1,21.2,243,1606,6.6,11,,ismail-mahdi-1
14,Jaydn Ott*,California,Pac-12,12,246,1315,5.3,12,109.6,25,169,6.8,2,14.1,271,1484,5.5,14,,jaydn-ott-1
15,Antario Brown*,Northern Illinois,MAC,13,212,1296,6.1,10,99.7,12,52,4.3,1,4.0,224,1348,6.0,11,,antario-brown-1
16,Devin Neal*,Kansas,Big 12,13,203,1280,6.3,16,98.5,25,217,8.7,1,16.7,228,1497,6.6,17,,devin-neal-3
17,Kyle Monangai*,Rutgers,Big Ten,13,242,1262,5.2,8,97.1,8,78,9.8,0,6.0,250,1340,5.4,8,,kyle-monangai-1
18,Blake Corum*,Michigan,Big Ten,15,258,1245,4.8,27,83.0,16,117,7.3,1,7.8,274,1362,5.0,28,H-9,blake-corum-1
19,DJ Giddens*,Kansas State,Big 12,13,223,1226,5.5,10,94.3,29,323,11.1,3,24.8,252,1549,6.1,13,,dj-giddens-1
20,Emani Bailey,TCU,Big 12,12,223,1209,5.4,8,100.8,25,184,7.4,1,15.3,248,1393,5.6,9,,emani-bailey-1
21,Dillon Johnson*,Washington,Pac-12,14,233,1195,5.1,16,85.4,24,190,7.9,0,13.6,257,1385,5.4,16,,dillon-johnson-1
22,Kairee Robinson*,San Jose State,MWC,12,170,1194,7.0,18,99.5,17,198,11.6,2,16.5,187,1392,7.4,20,,kairee-robinson-1
23,Jacory Croskey-Merritt,New Mexico,MWC,12,189,1190,6.3,17,99.2,7,72,10.3,1,6.0,196,1262,6.4,18,,jacory-croskey-merritt-1
24,Damien Martinez*,Oregon State,Pac-12,12,194,1185,6.1,9,98.8,11,126,11.5,0,10.5,205,1311,6.4,9,,damien-martinez-1
25,Bucky Irving*,Oregon,Pac-12,14,186,1180,6.3,11,84.3,56,413,7.4,2,29.5,242,1593,6.6,13,,markeise-irving-1
26,Quinshon Judkins*,Ole Miss,SEC,13,271,1158,4.3,15,89.1,22,149,6.8,2,11.5,293,1307,4.5,17,,quinshon-judkins-1
27,Kay'ron Adams,Massachusetts,Ind,12,236,1157,4.9,12,96.4,20,118,5.9,0,9.8,256,1275,5.0,12,,kayron-adams-1
28,Blake Watson*,Memphis,American,13,192,1152,6.0,14,88.6,53,480,9.1,3,36.9,245,1632,6.7,17,,blake-watson-2
29,Jonathon Brooks*,Texas,Big 12,11,187,1139,6.1,10,103.5,25,286,11.4,1,26.0,212,1425,6.7,11,,jonathon-brooks-1
30,Rasheen Ali*,Marshall,Sun Belt,12,212,1135,5.4,15,94.6,28,213,7.6,1,17.8,240,1348,5.6,16,,rasheen-ali-1
31,Jayden Daniels*,LSU,SEC,12,135,1134,8.4,10,94.5,0,0,,0,0.0,135,1134,8.4,10,H-1AACamp,jayden-daniels-1
32,Frank Gore Jr.,Southern Mississippi,Sun Belt,12,231,1131,4.9,10,94.3,27,221,8.2,3,18.4,258,1352,5.2,13,,frank-gore-jr-1
33,Re'Mahn Davis*,Kentucky,SEC,13,199,1129,5.7,14,86.8,33,323,9.8,7,24.8,232,1452,6.3,21,,remahn-davis-1
34,Jawhar Jordan*,Louisville,ACC,13,181,1128,6.2,13,86.8,21,246,11.7,1,18.9,202,1374,6.8,14,,jawhar-jordan-1
35,Thomas Castellanos*,Boston College,ACC,13,215,1113,5.2,13,85.6,2,-11,-5.5,0,-0.8,217,1102,5.1,13,,thomas-castellanos-1
36,Kaidon Salter*,Liberty,CUSA,14,163,1089,6.7,12,77.8,0,0,,0,0.0,163,1089,6.7,12,,kaidon-salter-1
37,Rashad Amos*,Miami (OH),MAC,14,210,1075,5.1,13,76.8,6,37,6.2,0,2.6,216,1112,5.1,13,,rashad-amos-1
38,LeQuint Allen*,Syracuse,ACC,13,245,1064,4.3,9,81.8,38,210,5.5,1,16.2,283,1274,4.5,10,,lequint-allen-1
39,Jamal Haynes*,Georgia Tech,ACC,13,174,1059,6.1,7,81.5,20,151,7.6,1,11.6,194,1210,6.2,8,,jamal-haynes-1
40,Corey Kiner,Cincinnati,Big 12,12,192,1047,5.5,5,87.3,12,49,4.1,0,4.1,204,1096,5.4,5,,corey-kiner-1
41,Marquez Cooper,Ball State,MAC,12,227,1043,4.6,4,86.9,18,163,9.1,0,13.6,245,1206,4.9,4,,marquez-cooper-1
42,Ayo Adeyi,North Texas,American,12,143,1017,7.1,6,84.8,7,52,7.4,0,4.3,150,1069,7.1,6,,ayo-adeyi-1
43,Jaylen Wright*,Tennessee,SEC,12,137,1013,7.4,4,84.4,22,141,6.4,0,11.8,159,1154,7.3,4,,jaylen-wright-1
44,La'Damian Webb*,South Alabama,Sun Belt,11,186,1007,5.4,16,91.5,24,144,6.0,1,13.1,210,1151,5.5,17,,ladamian-webb-1
45,Jalen Buckley,Western Michigan,MAC,11,189,1003,5.3,10,91.2,18,161,8.9,0,14.6,207,1164,5.6,10,,jalen-buckley-1
46,Braelon Allen*,Wisconsin,Big Ten,11,181,984,5.4,12,89.5,28,132,4.7,0,12.0,209,1116,5.3,12,,braelon-allen-1
47,Malik Sherrod*,Fresno State,MWC,12,172,966,5.6,9,80.5,44,260,5.9,1,21.7,216,1226,5.7,10,,malik-sherrod-1
48,Phil Mafah*,Clemson,ACC,13,179,965,5.4,13,74.2,21,108,5.1,0,8.3,200,1073,5.4,13,,phil-mafah-1
49,Emmanuel Michel*,Air Force,MWC,11,204,950,4.7,11,86.4,0,0,,0,0.0,204,950,4.7,11,,emmanuel-michel-1
50,Harrison Waylee*,Wyoming,MWC,10,164,947,5.8,5,94.7,12,66,5.5,0,6.6,176,1013,5.8,5,,harrison-waylee-1
51,TreVeyon Henderson*,Ohio State,Big Ten,10,156,926,5.9,11,92.6,19,229,12.1,0,22.9,175,1155,6.6,11,,treveyon-henderson-1
52,Diego Pavia*,New Mexico State,CUSA,15,176,923,5.2,7,61.5,0,0,,0,0.0,176,923,5.2,7,,diego-pavia-1
53,Jarquez Hunter*,Auburn,SEC,12,159,909,5.7,7,75.8,18,118,6.6,0,9.8,177,1027,5.8,7,,jarquez-hunter-1
54,Trey Benson*,Florida State,ACC,13,156,906,5.8,14,69.7,20,227,11.4,1,17.5,176,1133,6.4,15,,trey-benson-2
55,Kaytron Allen*,Penn State,Big Ten,13,172,902,5.2,6,69.4,14,81,5.8,1,6.2,186,983,5.3,7,,kaytron-allen-1
56,Bryson Daily,Army,Ind,11,215,901,4.2,7,81.9,0,0,,0,0.0,215,901,4.2,7,,bryson-daily-1
57,Malik Jackson*,Jacksonville State,CUSA,12,146,897,6.1,7,74.8,15,82,5.5,0,6.8,161,979,6.1,7,,malik-jackson-6
58,Jase McClellan*,Alabama,SEC,13,180,890,4.9,8,68.5,15,137,9.1,0,10.5,195,1027,5.3,8,,jase-mcclellan-1
59,Anthony Watkins,Tulsa,American,12,197,889,4.5,4,74.1,9,57,6.3,0,4.8,206,946,4.6,4,,anthony-watkins-3
60,Jalen White*,Georgia Southern,Sun Belt,11,160,889,5.6,9,80.8,17,69,4.1,1,6.3,177,958,5.4,10,,jalen-white-1
61,Daijun Edwards*,Georgia,SEC,12,164,881,5.4,13,73.4,20,197,9.9,0,16.4,184,1078,5.9,13,,daijun-edwards-1
62,Jonah Coleman*,Arizona,Pac-12,13,128,871,6.8,5,67.0,25,283,11.3,1,21.8,153,1154,7.5,6,,jonah-coleman-1
63,Bhayshul Tuten*,Virginia Tech,ACC,13,173,863,5.0,10,66.4,27,239,8.9,2,18.4,200,1102,5.5,12,,bhayshul-tuten-1
64,Carson Steele*,UCLA,Pac-12,12,167,847,5.1,6,70.6,17,163,9.6,2,13.6,184,1010,5.5,8,,carson-steele-1
65,Jahiem White*,West Virginia,Big 12,12,109,842,7.7,4,70.2,5,125,25.0,2,10.4,114,967,8.5,6,,jahiem-white-1
66,Quali Conley*,San Jose State,MWC,13,131,842,6.4,9,64.8,27,269,10.0,0,20.7,158,1111,7.0,9,,quali-conley-1
67,Nate Noel*,Appalachian State,Sun Belt,11,173,834,4.8,5,75.8,16,86,5.4,0,7.8,189,920,4.9,5,,nate-noel-1
68,TJ Harden*,UCLA,Pac-12,13,156,827,5.3,8,63.6,19,142,7.5,1,10.9,175,969,5.5,9,,tj-harden-1
69,Will Shipley*,Clemson,ACC,12,167,827,5.0,5,68.9,31,244,7.9,2,20.3,198,1071,5.4,7,,will-shipley-1
70,Leshon Williams*,Iowa,Big Ten,14,170,821,4.8,1,58.6,12,68,5.7,1,4.9,182,889,4.9,2,,leshon-williams-1
71,Marshawn Lloyd*,USC,Pac-12,11,116,820,7.1,9,74.5,13,232,17.8,0,21.1,129,1052,8.2,9,,marshawn-lloyd-1
72,Jordan Waters*,Duke,ACC,13,153,819,5.4,12,63.0,9,139,15.4,0,10.7,162,958,5.9,12,,jordan-waters-1
73,Kyron Drones*,Virginia Tech,ACC,13,166,818,4.9,5,62.9,1,0,0.0,0,0.0,167,818,4.9,5,,kyron-drones-1
74,Montrell Johnson,Florida,SEC,12,152,817,5.4,5,68.1,30,236,7.9,1,19.7,182,1053,5.8,6,,montrell-johnson-1
75,Deion Hankins,UTEP,CUSA,12,157,812,5.2,5,67.7,7,71,10.1,0,5.9,164,883,5.4,5,,deion-hankins-1
76,Devin Mockobee,Purdue,Big Ten,12,172,811,4.7,6,67.6,19,180,9.5,1,15.0,191,991,5.2,7,,devin-mockobee-1
77,Sieh Bangura*,Ohio,MAC,12,178,811,4.6,7,67.6,18,159,8.8,1,13.3,196,970,4.9,8,,sieh-bangura-1
78,Isaac Guerendo*,Louisville,ACC,14,132,810,6.1,11,57.9,22,234,10.6,0,16.7,154,1044,6.8,11,,isaac-guerendo-1
79,Byrum Brown*,South Florida,American,13,203,809,4.0,11,62.2,2,36,18.0,0,2.8,205,845,4.1,11,,byrum-brown-1
80,Davon Booth*,Utah State,MWC,12,120,805,6.7,6,67.1,12,50,4.2,0,4.2,132,855,6.5,6,,davon-booth-1
81,Jermaine Brown Jr.,UAB,American,12,158,803,5.1,12,66.9,41,416,10.1,1,34.7,199,1219,6.1,13,,jermaine-brown-jr-1
82,Darius Taylor*,Minnesota,Big Ten,6,138,799,5.8,5,133.2,11,92,8.4,0,15.3,149,891,6.0,5,,darius-taylor-1
83,CJ Donaldson*,West Virginia,Big 12,12,171,798,4.7,11,66.5,9,59,6.6,0,4.9,180,857,4.8,11,,cj-donaldson-1
84,Nate Carter,Michigan State,Big Ten,12,185,798,4.3,4,66.5,22,103,4.7,0,8.6,207,901,4.4,4,,nate-carter-4
85,Ja'Quinden Jackson*,Utah,Pac-12,12,161,797,5.0,4,66.4,9,53,5.9,0,4.4,170,850,5.0,4,,jaquinden-jackson-1
86,Nay'quan Wright*,South Florida,American,13,180,797,4.4,8,61.3,10,25,2.5,0,1.9,190,822,4.3,8,,nayquan-wright-1
87,Kendall Milton*,Georgia,SEC,13,121,790,6.5,14,60.8,4,25,6.3,0,1.9,125,815,6.5,14,,kendall-milton-1
88,Cameron Skattebo,Arizona State,Pac-12,12,164,783,4.8,9,65.3,24,286,11.9,1,23.8,188,1069,5.7,10,,cameron-skattebo-1
89,Kye Robichaux*,Boston College,ACC,11,163,780,4.8,8,70.9,15,108,7.2,0,9.8,178,888,5.0,8,,kye-robichaux-1
90,Garrett Greene*,West Virginia,Big 12,12,120,772,6.4,13,64.3,0,0,,0,0.0,120,772,6.4,13,,garrett-greene-1
91,Dean Connors*,Rice,American,13,121,771,6.4,7,59.3,43,403,9.4,3,31.0,164,1174,7.2,10,,dean-connors-1
92,Terion Stewart*,Bowling Green,MAC,9,125,762,6.1,8,84.7,1,27,27.0,0,3.0,126,789,6.3,8,,terion-stewart-1
93,Vincent Davis*,Nevada-Las Vegas,MWC,14,145,760,5.2,7,54.3,11,100,9.1,1,7.1,156,860,5.5,8,,vincent-davis-3
94,Jordan James*,Oregon,Pac-12,14,107,759,7.1,11,54.2,15,132,8.8,1,9.4,122,891,7.3,12,,jordan-james-3
95,Alex Tecza,Navy,American,12,126,758,6.0,5,63.2,16,97,6.1,0,8.1,142,855,6.0,5,,alex-tecza-1
96,Trevor Etienne,Florida,SEC,11,131,753,5.7,8,68.5,21,172,8.2,1,15.6,152,925,6.1,9,,trevor-etienne-1
97,Nicholas Singleton*,Penn State,Big Ten,13,171,752,4.4,8,57.8,26,308,11.8,2,23.7,197,1060,5.4,10,,nicholas-singleton-1
98,George Holani*,Boise State,MWC,8,134,748,5.6,7,93.5,17,199,11.7,0,24.9,151,947,6.3,7,,george-holani-1
99,Jaylan Knighton*,SMU,American,12,136,745,5.5,7,62.1,13,89,6.8,1,7.4,149,834,5.6,8,,jaylan-knighton-1
100,Gavin Sawchuk*,Oklahoma,Big 12,12,120,744,6.2,9,62.0,14,94,6.7,0,7.8,134,838,6.3,9,,gavin-sawchuk-1
101,Oscar Adaway III,North Texas,American,12,123,738,6.0,6,61.5,14,89,6.4,0,7.4,137,827,6.0,6,,oscar-adaway-iii-1
102,Haynes King*,Georgia Tech,ACC,13,120,737,6.1,10,56.7,0,0,,0,0.0,120,737,6.1,10,,haynes-king-1
103,Marion Lukes,Central Michigan,MAC,12,144,737,5.1,5,61.4,29,300,10.3,0,25.0,173,1037,6.0,5,,marion-lukes-1
104,Darren Grainger*,Georgia State,Sun Belt,13,159,736,4.6,10,56.6,0,0,,0,0.0,159,736,4.6,10,,darren-grainger-1
105,Rahsul Faison*,Utah State,MWC,13,118,736,6.2,5,56.6,11,52,4.7,0,4.0,129,788,6.1,5,,rahsul-faison-1
106,Jacob Kibodi*,Louisiana,Sun Belt,12,129,729,5.7,7,60.8,9,79,8.8,1,6.6,138,808,5.9,8,,jacob-kibodi-1
107,Kiael Kelly,Ball State,MAC,12,135,724,5.4,7,60.3,6,39,6.5,0,3.3,141,763,5.4,7,,kiael-kelly-1
108,Ja'Quez Cross*,Arkansas State,Sun Belt,13,128,716,5.6,7,55.1,24,161,6.7,0,12.4,152,877,5.8,7,,jaquez-cross-1
109,Tyrone Tracy Jr.,Purdue,Big Ten,11,113,716,6.3,8,65.1,19,132,6.9,0,12.0,132,848,6.4,8,,tyrone-tracy-jr-1
110,Kevorian Barnes*,UTSA,American,12,147,715,4.9,6,59.6,14,61,4.4,0,5.1,161,776,4.8,6,,kevorian-barnes-1
111,Zion Webb*,Jacksonville State,CUSA,12,132,708,5.4,7,59.0,0,0,,0,0.0,132,708,5.4,7,,zion-webb-1
112,Mario Anderson,South Carolina,SEC,12,143,707,4.9,3,58.9,22,153,7.0,1,12.8,165,860,5.2,4,,mario-anderson-1
113,Kanye Roberts*,Appalachian State,Sun Belt,14,123,696,5.7,7,49.7,14,113,8.1,0,8.1,137,809,5.9,7,,kanye-roberts-1
114,Larry McCammon III,Florida Atlantic,American,11,149,681,4.6,5,61.9,25,205,8.2,0,18.6,174,886,5.1,5,,larry-mccammon-iii-1
115,Roman Hemby*,Maryland,Big Ten,13,142,680,4.8,4,52.3,38,349,9.2,3,26.8,180,1029,5.7,7,,roman-hemby-1
116,Jaquez Moore*,Duke,ACC,13,116,674,5.8,6,51.8,4,64,16.0,0,4.9,120,738,6.2,6,,jaquez-moore-1
117,Brennan Armstrong*,North Carolina State,ACC,12,143,665,4.7,7,55.4,0,0,,0,0.0,143,665,4.7,7,,brennan-armstrong-1
118,CJ Baxter*,Texas,Big 12,13,138,659,4.8,5,50.7,24,156,6.5,0,12.0,162,815,5.0,5,,cj-baxter-1
119,Logan Diggs*,LSU,SEC,10,119,653,5.5,7,65.3,8,82,10.3,0,8.2,127,735,5.8,7,,logan-diggs-1
120,Star Thomas*,New Mexico State,CUSA,15,112,653,5.8,4,43.5,22,200,9.1,2,13.3,134,853,6.4,6,,star-thomas-1
121,Cam Porter*,Northwestern,Big Ten,13,166,651,3.9,4,50.1,21,121,5.8,1,9.3,187,772,4.1,5,,cam-porter-1
122,Treshaun Ward*,Kansas State,Big 12,11,124,643,5.2,5,58.5,17,129,7.6,2,11.7,141,772,5.5,7,,treshaun-ward-1
123,Lorenzo Lingard,Akron,MAC,12,143,641,4.5,4,53.4,38,368,9.7,2,30.7,181,1009,5.6,6,,lorenzo-lingard-1
124,Kaelon Black*,James Madison,Sun Belt,13,142,637,4.5,1,49.0,27,254,9.4,4,19.5,169,891,5.3,5,,kaelon-black-1
125,Samson Evans*,Eastern Michigan,MAC,12,142,635,4.5,12,52.9,12,89,7.4,0,7.4,154,724,4.7,12,,samson-evans-1
126,Daniel Hishaw Jr.*,Kansas,Big 12,13,121,626,5.2,8,48.2,1,9,9.0,0,0.7,122,635,5.2,8,,daniel-hishaw-jr-1
127,Henry Parrish Jr.*,Miami (FL),ACC,11,100,625,6.3,6,56.8,11,32,2.9,0,2.9,111,657,5.9,6,,henry-parrish-jr-1
128,Kadarius Calloway*,Old Dominion,Sun Belt,9,88,623,7.1,5,69.2,8,48,6.0,1,5.3,96,671,7.0,6,,kadarius-calloway-1
129,Torrance Burgess Jr.,UTEP,CUSA,11,124,620,5.0,2,56.4,17,227,13.4,0,20.6,141,847,6.0,2,,torrance-burgess-jr-1
130,Camryn Edwards,Connecticut,Ind,9,123,618,5.0,4,68.7,15,132,8.8,1,14.7,138,750,5.4,5,,camryn-edwards-1
131,Abu Sama*,Iowa State,Big 12,12,84,614,7.3,6,51.2,7,51,7.3,0,4.3,91,665,7.3,6,,abu-sama-1
132,Ron Cook Jr.,Buffalo,MAC,12,148,609,4.1,6,50.8,29,220,7.6,1,18.3,177,829,4.7,7,,ron-cook-jr-1
133,Zachar Larrier*,Air Force,MWC,11,142,605,4.3,6,55.0,1,-8,-8.0,0,-0.7,143,597,4.2,6,,zachar-larrier-1
134,Dylan Sampson*,Tennessee,SEC,12,106,604,5.7,7,50.3,17,175,10.3,1,14.6,123,779,6.3,8,,dylan-sampson-1
135,John Lee Eldridge III*,Air Force,MWC,13,84,599,7.1,6,46.1,7,39,5.6,1,3.0,91,638,7.0,7,,john-lee-eldridge-iii-1
136,Billy Lucas*,Liberty,CUSA,12,114,597,5.2,6,49.8,4,60,15.0,0,5.0,118,657,5.6,6,,billy-lucas-1
137,Keshawn Wicks*,Old Dominion,Sun Belt,11,120,589,4.9,4,53.5,12,83,6.9,1,7.5,132,672,5.1,5,,keshawn-wicks-1
138,Robert Henry*,UTSA,American,13,127,588,4.6,11,45.2,19,115,6.1,0,8.8,146,703,4.8,11,,robert-henry-1
139,Demond Claiborne,Wake Forest,ACC,10,137,586,4.3,5,58.6,3,35,11.7,0,3.5,140,621,4.4,5,,demond-claiborne-1
140,Jaylon Jackson*,Eastern Michigan,MAC,13,136,576,4.2,2,44.3,24,234,9.8,2,18.0,160,810,5.1,4,,jaylon-jackson-2
141,LJ Johnson Jr.*,SMU,American,11,108,576,5.3,4,52.4,7,58,8.3,0,5.3,115,634,5.5,4,,lj-johnson-jr-2
142,Zak Wallace*,Arkansas State,Sun Belt,12,126,575,4.6,6,47.9,6,23,3.8,0,1.9,132,598,4.5,6,,zak-wallace-1
143,Jacquez Stuart*,Toledo,MAC,12,110,574,5.2,6,47.8,12,143,11.9,1,11.9,122,717,5.9,7,,jacquez-stuart-1
144,Johnny Richardson*,UCF,Big 12,13,87,573,6.6,1,44.1,12,46,3.8,0,3.5,99,619,6.3,1,,johnny-richardson-4
145,Jo'quavious Marks,Mississippi State,SEC,9,121,573,4.7,4,63.7,23,167,7.3,2,18.6,144,740,5.1,6,,joquavious-marks-1
146,Ahmonte Watkins*,New Mexico State,CUSA,14,59,572,9.7,2,40.9,8,77,9.6,1,5.5,67,649,9.7,3,,ahmonte-watkins-1
147,Ty Son Lawton*,James Madison,Sun Belt,12,126,568,4.5,5,47.3,19,174,9.2,1,14.5,145,742,5.1,6,,ty-son-lawton-2
148,Reggie Love III,Illinois,Big Ten,8,116,567,4.9,4,70.9,9,58,6.4,0,7.3,125,625,5.0,4,,reggie-love-iii-1
149,Shomari Lawrence,Florida International,CUSA,12,125,566,4.5,4,47.2,8,47,5.9,0,3.9,133,613,4.6,4,,shomari-lawrence-1
150,DeQuan Finn*,Toledo,MAC,13,123,563,4.6,7,43.3,0,0,,0,0.0,123,563,4.6,7,,dequan-finn-1
151,Jaylon Glover*,Utah,Pac-12,13,137,562,4.1,2,43.2,7,67,9.6,0,5.2,144,629,4.4,2,,jaylon-glover-1
152,Emory Jones,Cincinnati,Big 12,12,155,560,3.6,4,46.7,0,0,,0,0.0,155,560,3.6,4,,emory-jones-1
153,Roydell Williams*,Alabama,SEC,14,111,560,5.0,5,40.0,11,58,5.3,1,4.1,122,618,5.1,6,,roydell-williams-2
154,Jordan Nubin*,Minnesota,Big Ten,13,127,559,4.4,3,43.0,6,27,4.5,0,2.1,133,586,4.4,3,,jordan-nubin-1
155,Aaron Bedgood*,Liberty,CUSA,14,58,552,9.5,3,39.4,21,220,10.5,2,15.7,79,772,9.8,5,,aaron-bedgood-1
156,Tyre Shelton,Louisiana Tech,CUSA,8,97,551,5.7,5,68.9,9,40,4.4,0,5.0,106,591,5.6,5,,tyre-shelton-1
157,Victor Rosa,Connecticut,Ind,11,112,550,4.9,3,50.0,12,69,5.8,0,6.3,124,619,5.0,3,,victor-rosa-1
158,Justice Ellison,Wake Forest,ACC,11,120,548,4.6,1,49.8,10,61,6.1,0,5.5,130,609,4.7,1,,justice-ellison-1
159,Rodney Hammond Jr.,Pitt,ACC,12,118,547,4.6,4,45.6,8,60,7.5,0,5.0,126,607,4.8,4,,rodney-hammond-jr-1
160,Gavin Garcia,Kent State,MAC,11,138,544,3.9,2,49.5,1,3,3.0,0,0.3,139,547,3.9,2,,gavin-garcia-1
161,Ulysses Bentley IV*,Ole Miss,SEC,13,95,540,5.7,4,41.5,11,87,7.9,1,6.7,106,627,5.9,5,,ulysses-bentley-iv-1
162,Amari Daniels*,Texas A&M,SEC,12,105,532,5.1,6,44.3,14,102,7.3,0,8.5,119,634,5.3,6,,amari-daniels-1
163,Jalen Milroe*,Alabama,SEC,13,161,531,3.3,12,40.8,0,0,,0,0.0,161,531,3.3,12,H-6,jalen-milroe-1
164,Jalen Mayden,San Diego State,MWC,12,128,528,4.1,5,44.0,0,0,,0,0.0,128,528,4.1,5,,jalen-mayden-1
165,Sean Dollars,Nevada,MWC,11,151,527,3.5,6,47.9,18,77,4.3,0,7.0,169,604,3.6,6,,sean-dollars-1
166,Kanye Udoh,Army,Ind,10,99,524,5.3,1,52.4,1,0,0.0,0,0.0,100,524,5.2,1,,kanye-udoh-1
167,Dominic Richardson,Baylor,Big 12,11,125,519,4.2,1,47.2,21,152,7.2,1,13.8,146,671,4.6,2,,dominic-richardson-1
168,LJ Martin,BYU,Big 12,10,109,518,4.8,4,51.8,11,45,4.1,1,4.5,120,563,4.7,5,,lj-martin-1
169,Deshaun Fenwick*,Oregon State,Pac-12,13,96,515,5.4,5,39.6,9,76,8.4,2,5.8,105,591,5.6,7,,deshaun-fenwick-1
170,Dre'lyn Washington*,Louisiana,Sun Belt,10,92,515,5.6,2,51.5,5,25,5.0,1,2.5,97,540,5.6,3,,drelyn-washington-1
171,Payton Thorne*,Auburn,SEC,13,134,515,3.8,3,39.6,0,0,,0,0.0,134,515,3.8,3,,payton-thorne-1
172,Mark Fletcher Jr.*,Miami (FL),ACC,10,105,514,4.9,5,51.4,7,62,8.9,0,6.2,112,576,5.1,5,,mark-fletcher-jr-1
173,Tawee Walker*,Oklahoma,Big 12,12,102,513,5.0,7,42.8,10,81,8.1,0,6.8,112,594,5.3,7,,tawee-walker-1
174,Hunter Smith,Louisiana-Monroe,Sun Belt,12,94,507,5.4,3,42.3,8,71,8.9,0,5.9,102,578,5.7,3,,hunter-smith-7
175,John Rhys Plumlee*,UCF,Big 12,10,106,505,4.8,5,50.5,0,0,,0,0.0,106,505,4.8,5,,john-rhys-plumlee-1
176,Dontae Smith*,Georgia Tech,ACC,11,100,504,5.0,4,45.8,10,92,9.2,1,8.4,110,596,5.4,5,,dontae-smith-1
177,Jai'Den Thomas*,Nevada-Las Vegas,MWC,13,108,503,4.7,12,38.7,7,62,8.9,0,4.8,115,565,4.9,12,,jaiden-thomas-1
178,Donovan Edwards*,Michigan,Big Ten,15,119,497,4.2,5,33.1,30,249,8.3,0,16.6,149,746,5.0,5,,donovan-edwards-1
179,Gavin Wimsatt*,Rutgers,Big Ten,13,131,497,3.8,11,38.2,0,0,,0,0.0,131,497,3.8,11,,gavin-wimsatt-1
180,Brendon Lewis,Nevada,MWC,12,120,495,4.1,4,41.3,0,0,,0,0.0,120,495,4.1,4,,brendon-lewis-1
181,Dylan Carson*,Air Force,MWC,9,68,493,7.3,2,54.8,0,0,,0,0.0,68,493,7.3,2,,dylan-carson-1
182,Zeon Chriss*,Louisiana,Sun Belt,8,73,492,6.7,6,61.5,0,0,,0,0.0,73,492,6.7,6,,zeon-chriss-1
183,Gavin Williams*,Northern Illinois,MAC,13,95,488,5.1,3,37.5,24,147,6.1,0,11.3,119,635,5.3,3,,gavin-williams-1
184,Aidan Robbins,BYU,Big 12,8,101,485,4.8,1,60.6,7,33,4.7,0,4.1,108,518,4.8,1,,aidan-robbins-1
185,Rahjai Harris,East Carolina,American,12,129,485,3.8,5,40.4,7,43,6.1,1,3.6,136,528,3.9,6,,rahjai-harris-1
186,Le'Veon Moss*,Texas A&M,SEC,9,96,484,5.0,5,53.8,11,84,7.6,0,9.3,107,568,5.3,5,,leveon-moss-1
187,Rocko Griffin*,UTSA,American,12,91,483,5.3,6,40.3,9,30,3.3,0,2.5,100,513,5.1,6,,rocko-griffin-1
188,Donald Chaney Jr.*,Miami (FL),ACC,11,94,478,5.1,2,43.5,5,15,3.0,0,1.4,99,493,5.0,2,,donald-chaney-jr-1
189,Austin Jones*,USC,Pac-12,13,85,477,5.6,7,36.7,13,103,7.9,1,7.9,98,580,5.9,8,,austin-jones-6
190,Eli Sanders*,Iowa State,Big 12,9,102,477,4.7,4,53.0,5,43,8.6,1,4.8,107,520,4.9,5,,eli-sanders-2
191,Heinrich Haarberg,Nebraska,Big Ten,10,120,477,4.0,5,47.7,2,12,6.0,0,1.2,122,489,4.0,5,,heinrich-haarberg-1
192,Jalon Jones,Charlotte,American,10,110,476,4.3,4,47.6,0,0,,0,0.0,110,476,4.3,4,,jalon-jones-2
193,Myles Bailey,Central Michigan,MAC,10,101,476,4.7,3,47.6,14,112,8.0,0,11.2,115,588,5.1,3,,myles-bailey-1
194,Jabari Small*,Tennessee,SEC,11,95,475,5.0,2,43.2,7,40,5.7,0,3.6,102,515,5.0,2,,jabari-small-1
195,Elijah Young*,Western Kentucky,CUSA,13,104,474,4.6,3,36.5,20,247,12.4,3,19.0,124,721,5.8,6,,elijah-young-1
196,Zahir Abdus-Salaam,Western Michigan,MAC,12,123,470,3.8,5,39.2,14,57,4.1,0,4.8,137,527,3.8,5,,zahir-abdus-salaam-1
197,Garrett Shrader*,Syracuse,ACC,11,113,469,4.2,8,42.6,4,1,0.3,0,0.1,117,470,4.0,8,,garrett-shrader-1
198,Ron Wiggins*,Jacksonville State,CUSA,8,92,468,5.1,6,58.5,9,77,8.6,0,9.6,101,545,5.4,6,,ron-wiggins-1
199,Parker Jenkins,Houston,Big 12,12,99,464,4.7,3,38.7,15,81,5.4,0,6.8,114,545,4.8,3,,parker-jenkins-1
200,Kaleb Johnson*,Iowa,Big Ten,10,117,463,4.0,3,46.3,3,25,8.3,0,2.5,120,488,4.1,3,,kaleb-johnson-2
201,Lawrance Toafili*,Florida State,ACC,13,69,463,6.7,4,35.6,21,186,8.9,1,14.3,90,649,7.2,5,,lawrance-toafili-1
202,Jaylen Thomas,Kent State,MAC,11,133,460,3.5,2,41.8,3,16,5.3,0,1.5,136,476,3.5,2,,jaylen-thomas-1
203,Donerio Davenport*,Texas State,Sun Belt,13,90,458,5.1,2,35.2,11,102,9.3,2,7.8,101,560,5.5,4,,donerio-davenport-1
204,Donavyn Lester*,Nevada-Las Vegas,MWC,13,95,455,4.8,9,35.0,5,18,3.6,0,1.4,100,473,4.7,9,,donavyn-lester-1
205,Kejon Owens,Florida International,CUSA,10,80,453,5.7,5,45.3,9,40,4.4,0,4.0,89,493,5.5,5,,kejon-owens-1
206,Anwar Lewis*,Jacksonville State,CUSA,9,93,452,4.9,3,50.2,11,96,8.7,0,10.7,104,548,5.3,3,,anwar-lewis-1
207,O'Shaan Allison*,Ohio,MAC,12,139,452,3.3,3,37.7,9,24,2.7,0,2.0,148,476,3.2,3,,oshaan-allison-1
208,Drake Maye*,North Carolina,ACC,12,112,449,4.0,9,37.4,0,0,,0,0.0,112,449,4.0,9,,drake-maye-1
209,Jaylon Armstead,San Diego State,MWC,12,103,448,4.3,8,37.3,3,16,5.3,0,1.3,106,464,4.4,8,,jaylon-armstead-1
210,Kentrel Bullock*,South Alabama,Sun Belt,11,83,448,5.4,4,40.7,15,106,7.1,1,9.6,98,554,5.7,5,,kentrel-bullock-2
211,Isaiah Woullard,Louisiana-Monroe,Sun Belt,12,98,447,4.6,1,37.3,9,26,2.9,1,2.2,107,473,4.4,2,,isaiah-woullard-1
212,K.J. Jefferson,Arkansas,SEC,12,161,447,2.8,2,37.3,0,0,,0,0.0,161,447,2.8,2,,kj-jefferson-1
213,Owen Burk*,Air Force,MWC,12,81,439,5.4,3,36.6,0,0,,0,0.0,81,439,5.4,3,,owen-burk-1
214,Kaden Feagin,Illinois,Big Ten,9,95,438,4.6,2,48.7,9,116,12.9,1,12.9,104,554,5.3,3,,kaden-feagin-1
215,Taylen Green*,Boise State,MWC,13,78,436,5.6,9,33.5,0,0,,0,0.0,78,436,5.6,9,,taylen-green-1
216,Rodrigues Clark,Southern Mississippi,Sun Belt,10,76,429,5.6,2,42.9,3,11,3.7,0,1.1,79,440,5.6,2,,rodrigues-clark-1
217,Donovan Smith,Houston,Big 12,12,138,428,3.1,6,35.7,1,28,28.0,1,2.3,139,456,3.3,7,,donovan-smith-2
218,Myles Montgomery,Cincinnati,Big 12,12,66,428,6.5,3,35.7,5,5,1.0,0,0.4,71,433,6.1,3,,myles-montgomery-1
219,Jaiden Credle,Middle Tennessee State,CUSA,12,90,427,4.7,2,35.6,24,144,6.0,1,12.0,114,571,5.0,3,,jaiden-credle-1
220,Collin Schlee*,UCLA,Pac-12,7,42,425,10.1,3,60.7,0,0,,0,0.0,42,425,10.1,3,,collin-schlee-1
221,Robert Briggs*,Utah State,MWC,11,80,420,5.3,2,38.2,6,11,1.8,0,1.0,86,431,5.0,2,,robert-briggs-1
222,Andrew Peasley*,Wyoming,MWC,12,110,419,3.8,7,34.9,0,0,,0,0.0,110,419,3.8,7,,andrew-peasley-1
223,Bill Jackson,Tulsa,American,12,91,414,4.5,1,34.5,8,50,6.3,0,4.2,99,464,4.7,1,,bill-jackson-4
224,Anthony Grant,Nebraska,Big Ten,11,104,413,4.0,3,37.5,4,13,3.3,0,1.2,108,426,3.9,3,,anthony-grant-1
225,Darvon Hubbard,Temple,American,12,83,412,5.0,3,34.3,27,249,9.2,0,20.8,110,661,6.0,3,,darvon-hubbard-1
226,Kobe Lewis,Florida Atlantic,American,11,85,412,4.8,3,37.5,18,100,5.6,0,9.1,103,512,5.0,3,,kobe-lewis-1
227,Emmett Johnson,Nebraska,Big Ten,12,90,411,4.6,2,34.3,7,46,6.6,0,3.8,97,457,4.7,2,,emmett-johnson-2
228,OJ Arnold*,Georgia Southern,Sun Belt,10,75,411,5.5,4,41.1,11,124,11.3,0,12.4,86,535,6.2,4,,oj-arnold-1
229,Camar Wheaton*,SMU,American,10,83,410,4.9,5,41.0,3,44,14.7,0,4.4,86,454,5.3,5,,camar-wheaton-1
230,Braydon Bennett*,Coastal Carolina,Sun Belt,12,91,407,4.5,5,33.9,23,200,8.7,0,16.7,114,607,5.3,5,,braydon-bennett-1
231,Jaydon Blue*,Texas,Big 12,14,65,398,6.1,3,28.4,14,135,9.6,1,9.6,79,533,6.7,4,,jaydon-blue-1
232,Elijah Gilliam*,Fresno State,MWC,13,95,397,4.2,5,30.5,11,120,10.9,1,9.2,106,517,4.9,6,,elijah-gilliam-1
233,Nicholas Vattiato,Middle Tennessee State,CUSA,12,139,397,2.9,2,33.1,0,0,,1,0.0,139,397,2.9,3,,nicholas-vattiato-1
234,Perris Jones,Virginia,ACC,10,76,393,5.2,2,39.3,6,107,17.8,0,10.7,82,500,6.1,2,,perris-jones-1
235,John Gentry,Sam Houston,CUSA,10,119,392,3.3,3,39.2,35,261,7.5,2,26.1,154,653,4.2,5,,john-gentry-1
236,Taron Keith*,Bowling Green,MAC,12,66,390,5.9,4,32.5,44,457,10.4,3,38.1,110,847,7.7,7,,taron-keith-1
237,Jaxson Dart*,Ole Miss,SEC,13,119,389,3.3,8,29.9,1,15,15.0,0,1.2,120,404,3.4,8,,jaxson-dart-1
238,Vann Schield,Colorado State,MWC,9,90,389,4.3,3,43.2,11,79,7.2,0,8.8,101,468,4.6,3,,vann-schield-1
239,British Brooks*,North Carolina,ACC,12,75,387,5.2,2,32.3,14,73,5.2,0,6.1,89,460,5.2,2,,british-brooks-1
240,Jeremiyah Love*,Notre Dame,Ind,13,71,385,5.4,1,29.6,8,77,9.6,1,5.9,79,462,5.8,2,,jeremiyah-love-1
241,Rueben Owens*,Texas A&M,SEC,13,101,385,3.8,3,29.6,12,109,9.1,0,8.4,113,494,4.4,3,,rueben-owens-1
242,Kobe Pace,Virginia,ACC,12,125,382,3.1,1,31.8,19,176,9.3,3,14.7,144,558,3.9,4,,kobe-pace-1
243,Malachi Thomas*,Virginia Tech,ACC,13,83,381,4.6,2,29.3,9,49,5.4,0,3.8,92,430,4.7,2,,malachi-thomas-1
244,Kenan Christon,San Diego State,MWC,12,96,378,3.9,0,31.5,29,201,6.9,1,16.8,125,579,4.6,1,,kenan-christon-1
245,Deamonte Trayanum*,Ohio State,Big Ten,12,85,373,4.4,3,31.1,9,53,5.9,0,4.4,94,426,4.5,3,,deamonte-trayanum-1
246,Dillon Gabriel*,Oklahoma,Big 12,12,93,373,4.0,12,31.1,0,0,,0,0.0,93,373,4.0,12,,dillon-gabriel-1
247,Jaylen Raynor*,Arkansas State,Sun Belt,11,123,373,3.0,5,33.9,0,0,,0,0.0,123,373,3.0,5,,jaylen--raynor-1
248,DJ Williams*,Arizona,Pac-12,12,85,372,4.4,5,31.0,1,2,2.0,0,0.2,86,374,4.3,5,,dj-williams-9
249,Sedrick Alexander,Vanderbilt,SEC,12,96,371,3.9,4,30.9,18,133,7.4,0,11.1,114,504,4.4,4,,sedrick-alexander-1
250,Ethan Vasko*,Coastal Carolina,Sun Belt,8,63,368,5.8,2,46.0,1,-7,-7.0,0,-0.9,64,361,5.6,2,,ethan-vasko-1
251,C'Bo Flemister,Pitt,ACC,12,98,367,3.7,2,30.6,8,106,13.3,1,8.8,106,473,4.5,3,,cbo-flemister-1
252,Isaiah Ifanse*,California,Pac-12,8,70,365,5.2,7,45.6,8,50,6.3,1,6.3,78,415,5.3,8,,isaiah-ifanse-1
253,Jase Bauer,Central Michigan,MAC,12,121,365,3.0,10,30.4,0,0,,0,0.0,121,365,3.0,10,,jase-bauer-1
254,Mike Washington,Buffalo,MAC,11,90,362,4.0,2,32.9,13,35,2.7,0,3.2,103,397,3.9,2,,mike-washington-5
255,Ajay Allen*,Miami (FL),ACC,9,70,361,5.2,5,40.1,4,9,2.3,0,1.0,74,370,5.0,5,,ajay-allen-1
256,Lee Beebe,UAB,American,11,52,360,6.9,4,32.7,14,98,7.0,0,8.9,66,458,6.9,4,,lee-beebe-1
257,Seth Davis,Mississippi State,SEC,12,59,356,6.0,1,29.7,6,19,3.2,0,1.6,65,375,5.8,1,,seth-davis-1
258,Trent Howland,Indiana,Big Ten,11,75,354,4.7,2,32.2,3,22,7.3,0,2.0,78,376,4.8,2,,trent-howland-1
259,Riley Leonard*,Duke,ACC,7,58,352,6.1,4,50.3,0,0,,0,0.0,58,352,6.1,4,,riley-leonard-1
260,Will Howard*,Kansas State,Big 12,12,81,351,4.3,9,29.3,1,8,8.0,1,0.7,82,359,4.4,10,,will-howard-2
261,Andrew Henry,New Mexico,MWC,9,52,350,6.7,3,38.9,5,40,8.0,0,4.4,57,390,6.8,3,,andrew-henry-2
262,Michel Dukes*,South Florida,American,9,63,350,5.6,2,38.9,8,77,9.6,0,8.6,71,427,6.0,2,,michel-dukes-1
263,Damien Taylor*,Troy,Sun Belt,13,67,346,5.2,1,26.6,4,9,2.3,1,0.7,71,355,5.0,2,,damien-taylor-2
264,Cartevious Norton*,Iowa State,Big 12,11,87,343,3.9,3,31.2,3,20,6.7,0,1.8,90,363,4.0,3,,cartevious-norton-1
265,Jamoni Jones*,New Mexico State,CUSA,15,87,343,3.9,3,22.9,7,59,8.4,0,3.9,94,402,4.3,3,,jamoni-jones-1
266,Dawson Pendergrass,Baylor,Big 12,11,79,338,4.3,5,30.7,26,199,7.7,2,18.1,105,537,5.1,7,,dawson-pendergrass-1
267,Josh Henderson,Indiana,Big Ten,8,81,337,4.2,2,42.1,10,125,12.5,1,15.6,91,462,5.1,3,,josh-henderson-2
268,Ethan Payne*,Marshall,Sun Belt,13,83,335,4.0,1,25.8,16,117,7.3,0,9.0,99,452,4.6,1,,ethan-payne-1
269,Jambres Dubar*,Boise State,MWC,12,62,335,5.4,2,27.9,6,11,1.8,0,0.9,68,346,5.1,2,,jambres-dubar-1
270,Justin Lamson,Stanford,Pac-12,12,120,334,2.8,5,27.8,0,0,,0,0.0,120,334,2.8,5,,justin-lamson-1
271,Beau Pribula*,Penn State,Big Ten,11,56,329,5.9,6,29.9,0,0,,0,0.0,56,329,5.9,6,,beau-pribula-1
272,Ryan Montgomery,Cincinnati,Big 12,8,54,329,6.1,1,41.1,11,91,8.3,2,11.4,65,420,6.5,3,,ryan-montgomery-1
273,Devon Dampier,New Mexico,MWC,9,59,328,5.6,4,36.4,1,1,1.0,0,0.1,60,329,5.5,4,,devon-dampier-1
274,Terron Kellman,Charlotte,American,8,82,328,4.0,1,41.0,2,23,11.5,0,2.9,84,351,4.2,1,,terron-kellman-1
275,Patrick Smith,Vanderbilt,SEC,11,79,327,4.1,2,29.7,4,15,3.8,0,1.4,83,342,4.1,2,,patrick-smith-3
276,Dan Villari*,Syracuse,ACC,13,55,326,5.9,2,25.1,20,180,9.0,3,13.8,75,506,6.7,5,,dan-villari-1
277,Juma Otoviano*,Rice,American,12,92,326,3.5,4,27.2,12,100,8.3,0,8.3,104,426,4.1,4,,juma-otoviano-1
278,Joquez Smith,Temple,American,10,71,325,4.6,1,32.5,10,51,5.1,1,5.1,81,376,4.6,2,,joquez-smith-1
279,Mike Wright,Mississippi State,SEC,12,71,324,4.6,3,27.0,0,0,,0,0.0,71,324,4.6,3,,mike-wright-8
280,Frank Harris*,UTSA,American,10,86,323,3.8,4,32.3,0,0,,0,0.0,86,323,3.8,4,,frank-harris-3
281,Hashaun Wilson,Charlotte,American,10,54,322,6.0,3,32.2,2,2,1.0,0,0.2,56,324,5.8,3,,hashaun-wilson-1
282,Jackson Acker*,Wisconsin,Big Ten,12,72,322,4.5,2,26.8,19,108,5.7,1,9.0,91,430,4.7,3,,jackson-acker-1
283,Logan Smothers*,Jacksonville State,CUSA,12,85,322,3.8,7,26.8,0,0,,0,0.0,85,322,3.8,7,,logan-smothers-1
284,Dylan Edwards,Colorado,Pac-12,12,76,321,4.2,1,26.8,36,299,8.3,4,24.9,112,620,5.5,5,,dylan-edwards-1
285,Nakia Watson,Washington State,Pac-12,12,89,321,3.6,4,26.8,24,230,9.6,3,19.2,113,551,4.9,7,,nakia-watson-1
286,Damari Alston*,Auburn,SEC,10,64,320,5.0,2,32.0,8,48,6.0,0,4.8,72,368,5.1,2,,damari-alston-1
287,Kevin Concepcion*,North Carolina State,ACC,13,41,320,7.8,0,24.6,71,839,11.8,10,64.5,112,1159,10.3,10,,kevin-concepcion-2
288,Anthony Hankerson,Colorado,Pac-12,12,78,319,4.1,1,26.6,16,71,4.4,1,5.9,94,390,4.1,2,,anthony-hankerson-1
289,Brady Cook*,Missouri,SEC,13,113,319,2.8,8,24.5,0,0,,0,0.0,113,319,2.8,8,,brady-cook-1
290,Maquel Haywood*,Appalachian State,Sun Belt,13,60,318,5.3,2,24.5,0,0,,0,0.0,60,318,5.3,2,,maquel-haywood-1
291,Nathaniel Peat*,Missouri,SEC,12,76,317,4.2,3,26.4,6,81,13.5,1,6.8,82,398,4.9,4,,nathaniel-peat-1
292,Sione Vaki*,Utah,Pac-12,12,42,317,7.5,2,26.4,11,203,18.5,3,16.9,53,520,9.8,5,,sione-vaki-1
293,AJ Green,Arkansas,SEC,12,67,312,4.7,2,26.0,6,25,4.2,1,2.1,73,337,4.6,3,,aj-green-6
294,Justin Marshall,Colorado State,MWC,3,57,311,5.5,2,103.7,2,23,11.5,0,7.7,59,334,5.7,2,,justin-marshall-2
295,Michael Wiley*,Arizona,Pac-12,10,70,311,4.4,3,31.1,28,306,10.9,5,30.6,98,617,6.3,8,,michael-wiley-3
296,Markese Stepp*,Western Kentucky,CUSA,11,69,310,4.5,3,28.2,7,73,10.4,0,6.6,76,383,5.0,3,,markese-stepp-1
297,Kendrick Raphael*,North Carolina State,ACC,11,67,309,4.6,1,28.1,10,96,9.6,0,8.7,77,405,5.3,1,,kendrick-raphael-1
298,Marcus Major*,Oklahoma,Big 12,7,78,308,3.9,1,44.0,12,75,6.3,1,10.7,90,383,4.3,2,,marcus-major-1
299,Freddie Brock*,Georgia State,Sun Belt,4,30,307,10.2,1,76.8,2,15,7.5,0,3.8,32,322,10.1,1,,freddie-brock-1
300,Chez Mellusi*,Wisconsin,Big Ten,4,51,306,6.0,4,76.5,3,12,4.0,0,3.0,54,318,5.9,4,,chez-mellusi-1
301,Colby McDonald*,Maryland,Big Ten,12,53,306,5.8,2,25.5,5,16,3.2,0,1.3,58,322,5.6,2,,colby-mcdonald-1
302,Frank Peasant,Middle Tennessee State,CUSA,9,81,306,3.8,4,34.0,16,126,7.9,0,14.0,97,432,4.5,4,,frank-peasant-1
303,Richard Reese,Baylor,Big 12,12,66,306,4.6,2,25.5,7,24,3.4,0,2.0,73,330,4.5,2,,richard-reese-1
304,Sutton Smith*,Memphis,American,13,63,305,4.8,2,23.5,18,152,8.4,2,11.7,81,457,5.6,4,,sutton-smith-2
305,Tanner Mordecai*,Wisconsin,Big Ten,10,90,302,3.4,4,30.2,2,14,7.0,0,1.4,92,316,3.4,4,,tanner-mordecai-1
306,Gregory Desrosiers,Massachusetts,Ind,11,37,301,8.1,4,27.4,15,185,12.3,2,16.8,52,486,9.3,6,,gregory-desrosiers-1
307,Joe Milton*,Tennessee,SEC,12,78,299,3.8,7,24.9,1,6,6.0,0,0.5,79,305,3.9,7,,joe-milton-2
308,Avery Johnson*,Kansas State,Big 12,8,52,296,5.7,7,37.0,0,0,,0,0.0,52,296,5.7,7,,avery-johnson-2
309,Jordan Ford,Tulsa,American,12,78,294,3.8,1,24.5,9,24,2.7,0,2.0,87,318,3.7,1,,jordan-ford-2
310,Ashton Daniels,Stanford,Pac-12,12,109,292,2.7,3,24.3,0,0,,0,0.0,109,292,2.7,3,,ashton-daniels-1
311,Grant Wilson*,Old Dominion,Sun Belt,12,130,289,2.2,4,24.1,1,26,26.0,1,2.2,131,315,2.4,5,,grant-wilson-1
312,Alex Broome*,Boston College,ACC,11,60,288,4.8,1,26.2,8,52,6.5,1,4.7,68,340,5.0,2,,alex-broome-1
313,Keith Willis Jr.,Louisiana Tech,CUSA,7,51,288,5.6,7,41.1,3,6,2.0,0,0.9,54,294,5.4,7,,keith-willis-jr-1
314,Bennett Galloway,Louisiana-Monroe,Sun Belt,10,44,287,6.5,0,28.7,2,22,11.0,0,2.2,46,309,6.7,0,,bennett-galloway-1
315,Cam'Ron Valdez*,Texas Tech,Big 12,10,52,286,5.5,1,28.6,3,27,9.0,0,2.7,55,313,5.7,1,,camron-valdez-1
316,Michael Pratt*,Tulane,American,11,98,286,2.9,5,26.0,0,0,,0,0.0,98,286,2.9,5,,michael-pratt-1
317,Josh Williams*,LSU,SEC,13,55,284,5.2,5,21.8,14,194,13.9,1,14.9,69,478,6.9,6,,josh-williams-10
318,Maurice Turner*,Louisville,ACC,14,62,284,4.6,1,20.3,11,87,7.9,0,6.2,73,371,5.1,1,,maurice-turner-2
319,Anderson Castle*,Appalachian State,Sun Belt,6,53,283,5.3,2,47.2,5,35,7.0,0,5.8,58,318,5.5,2,,anderson-castle-1
320,Daba Fofana,Navy,American,12,72,283,3.9,3,23.6,5,46,9.2,0,3.8,77,329,4.3,3,,daba-fofana-1
321,Delbert Mimms*,North Carolina State,ACC,13,96,282,2.9,8,21.7,3,23,7.7,0,1.8,99,305,3.1,8,,delbert-mimms-1
322,Luke Altmyer,Illinois,Big Ten,9,94,282,3.0,3,31.3,0,0,,0,0.0,94,282,3.0,3,,luke-altmyer-1
323,Stacy Sneed,Houston,Big 12,12,48,282,5.9,1,23.5,13,95,7.3,1,7.9,61,377,6.2,2,,stacy-sneed-1
324,Aveon Smith*,Miami (OH),MAC,10,75,280,3.7,1,28.0,0,0,,0,0.0,75,280,3.7,1,,aveon-smith-1
325,Jason Bean*,Kansas,Big 12,12,47,280,6.0,3,23.3,0,0,,0,0.0,47,280,6.0,3,,jason-bean-1
326,Jayden Maiava*,Nevada-Las Vegas,MWC,14,73,277,3.8,3,19.8,0,0,,0,0.0,73,277,3.8,3,,jayden-maiava-1
327,Brendan Sorsby,Indiana,Big Ten,10,113,276,2.4,4,27.6,0,0,,0,0.0,113,276,2.4,4,,brendan-sorsby-1
328,Jordan McCloud*,James Madison,Sun Belt,13,96,276,2.9,8,21.2,0,0,,0,0.0,96,276,2.9,8,,jordan-mccloud-1
329,Jaylin Lucas,Indiana,Big Ten,12,67,275,4.1,2,22.9,34,247,7.3,2,20.6,101,522,5.2,4,,jaylin-lucas-1
330,Mike Hollins,Virginia,ACC,11,80,274,3.4,7,24.9,10,34,3.4,1,3.1,90,308,3.4,8,,mike-hollins-1
331,Seth Henigan*,Memphis,American,13,94,274,2.9,5,21.1,0,0,,0,0.0,94,274,2.9,5,,seth-henigan-1
332,Trevion Cooley*,Georgia Tech,ACC,12,64,274,4.3,3,22.8,11,112,10.2,1,9.3,75,386,5.1,4,,trevion-cooley-1
333,Cam Fancher*,Marshall,Sun Belt,10,120,273,2.3,4,27.3,0,0,,0,0.0,120,273,2.3,4,,cam-fancher-1
334,Chevan Cordeiro*,San Jose State,MWC,13,81,272,3.4,3,20.9,0,0,,0,0.0,81,272,3.4,3,,chevan-cordeiro-1
335,Jadarian Price*,Notre Dame,Ind,13,47,272,5.8,3,20.9,5,65,13.0,1,5.0,52,337,6.5,4,,jadarian-price-1
336,Charvis Thornton,Louisiana Tech,CUSA,10,55,270,4.9,1,27.0,7,28,4.0,1,2.8,62,298,4.8,2,,charvis-thornton-1
337,Patrick Garwo*,Boston College,ACC,5,52,270,5.2,1,54.0,4,19,4.8,0,3.8,56,289,5.2,1,,patrick-garwo-1
338,Jeffery Pittman,Mississippi State,SEC,11,54,268,5.0,1,24.4,13,91,7.0,2,8.3,67,359,5.4,3,,jeffery-pittman-1
339,Bryson Barnes*,Utah,Pac-12,11,90,265,2.9,3,24.1,0,0,,0,0.0,90,265,2.9,3,,bryson-barnes-1
340,Jiya Wright,Louisiana-Monroe,Sun Belt,12,99,264,2.7,2,22.0,0,0,,0,0.0,99,264,2.7,2,,jiya-wright-1
341,Avery Morrow,Colorado State,MWC,9,81,262,3.2,2,29.1,3,8,2.7,0,0.9,84,270,3.2,2,,avery-morrow-1
342,CJ Beasley*,Coastal Carolina,Sun Belt,11,68,262,3.9,2,23.8,15,151,10.1,0,13.7,83,413,5.0,2,,cj-beasley-1
343,Rashod Dubinion,Arkansas,SEC,10,82,260,3.2,1,26.0,14,85,6.1,1,8.5,96,345,3.6,2,,rashod-dubinion-1
344,DeCarlos Brooks,Arizona State,Pac-12,5,48,259,5.4,3,51.8,7,47,6.7,0,9.4,55,306,5.6,3,,decarlos-brooks-1
345,Xavier Arline,Navy,American,9,77,257,3.3,2,28.6,2,7,3.5,0,0.8,79,264,3.3,2,,xavier-arline-1
346,Antwaine Littleton*,Maryland,Big Ten,12,69,255,3.7,2,21.3,4,21,5.3,0,1.8,73,276,3.8,2,,antwaine-littleton-1
347,Landon Sims,Hawaii,MWC,11,63,255,4.0,1,23.2,14,106,7.6,0,9.6,77,361,4.7,1,,landon-sims-1
348,Keegan Shoemaker,Sam Houston,CUSA,11,93,254,2.7,1,23.1,1,1,1.0,0,0.1,94,255,2.7,1,,keegan-shoemaker-1
349,Dylan McDuffie*,Kansas,Big 12,13,45,253,5.6,4,19.5,0,0,,0,0.0,45,253,5.6,4,,dylan-mcduffie-1
350,Jared Brown*,Coastal Carolina,Sun Belt,12,15,252,16.8,1,21.0,58,740,12.8,4,61.7,73,992,13.6,5,,jared-brown-2
351,Reese White*,Coastal Carolina,Sun Belt,11,77,252,3.3,2,22.9,9,43,4.8,0,3.9,86,295,3.4,2,,reese-white-1
352,James Jointer*,Liberty,CUSA,9,43,251,5.8,2,27.9,1,7,7.0,0,0.8,44,258,5.9,2,,james-jointer-1
353,Michael Allen*,North Carolina State,ACC,10,52,251,4.8,1,25.1,11,66,6.0,0,6.6,63,317,5.0,1,,michael-allen-3
354,Kenny Tracy*,Miami (OH),MAC,11,46,250,5.4,2,22.7,10,126,12.6,1,11.5,56,376,6.7,3,,kenny-tracy-1
355,Chandler Morris,TCU,Big 12,7,45,249,5.5,3,35.6,0,0,,0,0.0,45,249,5.5,3,,chandler-morris-1
356,Isaiah Jacobs,UAB,American,5,55,249,4.5,3,49.8,17,63,3.7,0,12.6,72,312,4.3,3,,isaiah-jacobs-1
357,Jacqez Barksdale,Buffalo,MAC,11,52,248,4.8,2,22.5,6,8,1.3,0,0.7,58,256,4.4,2,,jacqez-barksdale-1
358,Obie Sanni*,Old Dominion,Sun Belt,8,57,248,4.4,1,31.0,6,56,9.3,0,7.0,63,304,4.8,1,,obie-sanni-1
359,Joey Aguilar*,Appalachian State,Sun Belt,14,81,245,3.0,3,17.5,0,0,,0,0.0,81,245,3.0,3,,joey-aguilar-1
360,Tai Lavatai,Navy,American,8,75,245,3.3,2,30.6,0,0,,0,0.0,75,245,3.3,2,,tai-lavatai-1
361,Tate Carney,Wake Forest,ACC,12,49,244,5.0,4,20.3,3,35,11.7,0,2.9,52,279,5.4,4,,tate-carney-1
362,Sean Tyler*,Minnesota,Big Ten,11,61,242,4.0,0,22.0,4,5,1.3,0,0.5,65,247,3.8,0,,sean-tyler-1
363,Davion Ervin-Poindexter*,Western Kentucky,CUSA,13,63,241,3.8,1,18.5,21,148,7.0,1,11.4,84,389,4.6,2,,davion-ervin-poindexter-1
364,Anthony Tyus III*,Northwestern,Big Ten,12,50,238,4.8,1,19.8,2,16,8.0,0,1.3,52,254,4.9,1,,anthony-tyus-iii-1
365,Sam Scott*,Wyoming,MWC,13,49,237,4.8,2,18.2,11,77,7.0,0,5.9,60,314,5.2,2,,sam-scott-1
366,Nate Johnson*,Utah,Pac-12,8,59,235,4.0,4,29.4,0,0,,0,0.0,59,235,4.0,4,,nate-johnson-3
367,Bo Nix*,Oregon,Pac-12,14,54,234,4.3,6,16.7,0,0,,0,0.0,54,234,4.3,6,H-3,bo-nix-1
368,Courtney Reese*,Nevada-Las Vegas,MWC,13,59,233,3.9,4,17.9,4,11,2.8,0,0.8,63,244,3.9,4,,courtney-reese-1
369,Jensen Jones*,Air Force,MWC,10,47,233,5.0,4,23.3,1,4,4.0,0,0.4,48,237,4.9,4,,jensen-jones-1
370,Braylon McReynolds*,South Alabama,Sun Belt,5,46,232,5.0,0,46.4,18,141,7.8,0,28.2,64,373,5.8,0,,braylon-mcreynolds-1
371,Javious Bond,East Carolina,American,9,40,231,5.8,1,25.7,10,52,5.2,0,5.8,50,283,5.7,1,,javious-bond-1
372,Edward Saydee,Temple,American,12,68,230,3.4,0,19.2,18,164,9.1,2,13.7,86,394,4.6,2,,edward-saydee-1
373,Zach Evans*,Minnesota,Big Ten,6,52,230,4.4,1,38.3,2,15,7.5,0,2.5,54,245,4.5,1,,zach-evans-2
374,Isaiah Johnson,North Texas,American,7,37,229,6.2,3,32.7,9,36,4.0,0,5.1,46,265,5.8,3,,isaiah-johnson-10
375,Malik Hornsby*,Texas State,Sun Belt,7,35,229,6.5,6,32.7,1,2,2.0,0,0.3,36,231,6.4,6,,malik-hornsby-1
376,Brian Battie*,Auburn,SEC,13,51,227,4.5,1,17.5,7,52,7.4,0,4.0,58,279,4.8,1,,brian-battie-1
377,Christian Turner,Indiana,Big Ten,12,52,227,4.4,2,18.9,4,0,0.0,0,0.0,56,227,4.1,2,,christian-turner-1
378,Mason Garcia,East Carolina,American,8,50,227,4.5,2,28.4,0,0,,0,0.0,50,227,4.5,2,,mason-garcia-1
379,Anthony Colandrea,Virginia,ACC,8,73,225,3.1,0,28.1,0,0,,0,0.0,73,225,3.1,0,,anthony-colandrea-1
380,Cam Davis,San Diego State,MWC,12,52,225,4.3,0,18.8,16,53,3.3,0,4.4,68,278,4.1,0,,cam-davis-1
381,Kalel Mullings*,Michigan,Big Ten,13,36,222,6.2,1,17.1,2,32,16.0,0,2.5,38,254,6.7,1,,kalel-mullings-1
382,Bert Emanuel Jr.,Central Michigan,MAC,6,50,220,4.4,2,36.7,0,0,,0,0.0,50,220,4.4,2,,bert-emanuel-jr-1
383,Marco Lee*,South Alabama,Sun Belt,12,53,220,4.2,2,18.3,1,8,8.0,0,0.7,54,228,4.2,2,,marco-lee-1
384,D.J. Uiagalelei*,Oregon State,Pac-12,12,68,219,3.2,6,18.3,0,0,,0,0.0,68,219,3.2,6,,dj-uiagalelei-1
385,Kurtis Rourke*,Ohio,MAC,11,67,219,3.3,4,19.9,1,7,7.0,0,0.6,68,226,3.3,4,,kurtis-rourke-1
386,E.J. Smith,Stanford,Pac-12,12,53,218,4.1,1,18.2,33,242,7.3,0,20.2,86,460,5.3,1,,ej-smith-2
387,Robby Ashford*,Auburn,SEC,10,46,217,4.7,5,21.7,1,2,2.0,0,0.2,47,219,4.7,5,,robby-ashford-1
388,Samuel Brown V*,Rutgers,Big Ten,12,63,216,3.4,2,18.0,2,29,14.5,0,2.4,65,245,3.8,2,,samuel-brown-v-1
389,Casey Filkins,Stanford,Pac-12,8,38,215,5.7,1,26.9,6,41,6.8,0,5.1,44,256,5.8,1,,casey-filkins-1
390,Demarcus Irons Jr.,Akron,MAC,5,61,215,3.5,2,43.0,0,0,,0,0.0,61,215,3.5,2,,demarcus-irons-jr-1
391,K'wan Powell*,South Florida,American,9,61,215,3.5,1,23.9,6,36,6.0,0,4.0,67,251,3.7,1,,kwan-powell-1
392,CJ Ogbonna,Buffalo,MAC,8,51,214,4.2,3,26.8,0,0,,0,0.0,51,214,4.2,3,,cj-ogbonna-1
393,Eli Heidenreich,Navy,American,12,27,214,7.9,1,17.8,19,382,20.1,4,31.8,46,596,13.0,5,,eli-heidenreich-1
394,Zylan Perry*,Louisiana,Sun Belt,13,54,213,3.9,2,16.4,3,25,8.3,0,1.9,57,238,4.2,2,,zylan-perry-1
395,Dylan Downing,Purdue,Big Ten,12,48,211,4.4,1,17.6,5,44,8.8,0,3.7,53,255,4.8,1,,dylan-downing-2
396,Max Balthazar*,Coastal Carolina,Sun Belt,13,43,211,4.9,2,16.2,11,82,7.5,1,6.3,54,293,5.4,3,,max-balthazar-1
397,Shadrick Byrd,Charlotte,American,8,60,211,3.5,0,26.4,7,28,4.0,0,3.5,67,239,3.6,0,,shadrick-byrd-1
398,Levi Williams*,Utah State,MWC,11,45,209,4.6,3,19.0,0,0,,0,0.0,45,209,4.6,3,,levi-williams-1
399,Raheim Sanders,Arkansas,SEC,6,62,209,3.4,2,34.8,10,75,7.5,0,12.5,72,284,3.9,2,,raheim-sanders-1
400,Camden Orth*,Bowling Green,MAC,12,67,208,3.1,5,17.3,0,0,,0,0.0,67,208,3.1,5,,camden-orth-1
401,Drew Allar*,Penn State,Big Ten,13,74,206,2.8,4,15.8,2,14,7.0,0,1.1,76,220,2.9,4,,drew-allar-1
402,Jaziun Patterson*,Iowa,Big Ten,11,58,206,3.6,2,18.7,4,22,5.5,0,2.0,62,228,3.7,2,,jaziun-patterson-1
403,Hayden Reed,Army,Ind,9,50,205,4.1,2,22.8,4,29,7.3,0,3.2,54,234,4.3,2,,hayden-reed-1
404,Hudson Card,Purdue,Big Ten,11,93,203,2.2,5,18.5,0,0,,0,0.0,93,203,2.2,5,,hudson-card-1
405,Isaiah Augustave,Arkansas,SEC,11,35,202,5.8,1,18.4,3,7,2.3,0,0.6,38,209,5.5,1,,isaiah-augustave-1
406,J.J. McCarthy*,Michigan,Big Ten,15,64,202,3.2,3,13.5,0,0,,0,0.0,64,202,3.2,3,H-10,jj-mccarthy-1
407,Jamarion Miller*,Alabama,SEC,14,41,201,4.9,1,14.4,4,73,18.3,1,5.2,45,274,6.1,2,,jamarion-miller-1
408,Will Nixon*,Washington,Pac-12,15,33,201,6.1,1,13.4,13,84,6.5,0,5.6,46,285,6.2,1,,will-nixon-1
409,Ashton Stredick*,California,Pac-12,10,42,200,4.8,2,20.0,4,27,6.8,0,2.7,46,227,4.9,2,,ashton-stredick-1
410,Cardell Williams,Tulsa,American,9,57,198,3.5,5,22.0,0,0,,0,0.0,57,198,3.5,5,,cardell-williams-1
411,Jordan Johnson,Hawaii,MWC,6,34,198,5.8,0,33.0,9,54,6.0,0,9.0,43,252,5.9,0,,jordan-johnson-10
412,Preston Stone*,SMU,American,12,62,198,3.2,4,16.5,0,0,,0,0.0,62,198,3.2,4,,preston-stone-1
413,Jaden Nixon*,Oklahoma State,Big 12,12,50,197,3.9,1,16.4,12,123,10.3,1,10.3,62,320,5.2,2,,jaden-nixon-1
414,Gabe Ervin Jr.,Nebraska,Big Ten,3,38,196,5.2,1,65.3,2,20,10.0,0,6.7,40,216,5.4,1,,gabe-ervin-jr-1
415,Roderick Robinson II*,Georgia,SEC,5,24,196,8.2,2,39.2,0,0,,0,0.0,24,196,8.2,2,,roderick-robinson-ii-1
416,Makhilyn Young*,New Mexico State,CUSA,11,28,191,6.8,2,17.4,1,1,1.0,0,0.1,29,192,6.6,2,,makhilyn-young-1
417,Rodney Hill*,Florida State,ACC,12,50,190,3.8,1,15.8,5,83,16.6,0,6.9,55,273,5.0,1,,rodney-hill-1
418,Sy'veon Wilkerson,Colorado,Pac-12,11,53,190,3.6,3,17.3,5,50,10.0,0,4.5,58,240,4.1,3,,syveon-wilkerson-1
419,Xavier Johnson*,Ohio State,Big Ten,13,28,190,6.8,0,14.6,13,178,13.7,0,13.7,41,368,9.0,0,,xavier-johnson-2
420,Elijah Davis*,Louisiana,Sun Belt,5,36,189,5.3,3,37.8,1,4,4.0,0,0.8,37,193,5.2,3,,elijah-davis-5
421,Jeff Sims,Nebraska,Big Ten,5,42,189,4.5,1,37.8,0,0,,0,0.0,42,189,4.5,1,,jeff-sims-1
422,Alex Flinn,East Carolina,American,12,96,188,2.0,0,15.7,0,0,,0,0.0,96,188,2.0,0,,alex-flinn-1
423,Jamari Ferrell*,Wyoming,MWC,11,52,188,3.6,1,17.1,2,7,3.5,0,0.6,54,195,3.6,1,,jamari-ferrell-1
424,Tahj Gary,Tulsa,American,5,33,187,5.7,2,37.4,1,4,4.0,0,0.8,34,191,5.6,2,,tahj-gary-1
425,Tyrell Robinson,Army,Ind,8,39,187,4.8,2,23.4,6,77,12.8,0,9.6,45,264,5.9,2,,tyrell-robinson-2
426,Caziah Holmes*,Florida State,ACC,14,29,185,6.4,2,13.2,5,58,11.6,2,4.1,34,243,7.1,4,,caziah-holmes-1
427,Ramon Jefferson*,Kentucky,SEC,11,28,184,6.6,0,16.7,0,0,,0,0.0,28,184,6.6,0,,ramon-jefferson-2
428,Tybo Rogers*,Washington,Pac-12,12,44,184,4.2,0,15.3,6,72,12.0,0,6.0,50,256,5.1,0,,tybo-rogers-1
429,AJ Bianco,Nevada,MWC,8,42,183,4.4,1,22.9,0,0,,0,0.0,42,183,4.4,1,,aj-bianco-1
430,Blake Horvath,Navy,American,4,37,183,4.9,0,45.8,0,0,,0,0.0,37,183,4.9,0,,blake-horvath-1
431,Cade Klubnik*,Clemson,ACC,13,125,182,1.5,4,14.0,0,0,,0,0.0,125,182,1.5,4,,cade-klubnik-1
432,Devin Roche*,Old Dominion,Sun Belt,5,32,182,5.7,0,36.4,4,19,4.8,0,3.8,36,201,5.6,0,,devin-roche-1
433,Trayvon Rudolph*,Northern Illinois,MAC,13,22,182,8.3,1,14.0,51,531,10.4,2,40.8,73,713,9.8,3,,trayvon-rudolph-1
434,Ay'Juan Marshall,Army,Ind,11,17,181,10.6,1,16.5,9,83,9.2,0,7.5,26,264,10.2,1,,ayjuan-marshall-1
435,Noah Cain*,LSU,SEC,13,37,181,4.9,3,13.9,1,6,6.0,1,0.5,38,187,4.9,4,,noah-cain-1
436,Chandler Rogers,North Texas,American,12,109,180,1.7,4,15.0,0,0,,0,0.0,109,180,1.7,4,,chandler-rogers-3
437,Chubba Purdy,Nebraska,Big Ten,6,29,180,6.2,1,30.0,0,0,,0,0.0,29,180,6.2,1,,chubba-purdy-1
438,Mike Franklin,UTEP,CUSA,8,45,180,4.0,3,22.5,4,35,8.8,0,4.4,49,215,4.4,3,,mike-franklin-1
439,Kenyon Clay,Southern Mississippi,Sun Belt,11,40,179,4.5,1,16.3,1,5,5.0,0,0.5,41,184,4.5,1,,kenyon-clay-1
440,Anthony Adkins*,UCLA,Pac-12,11,30,178,5.9,1,16.2,0,0,,0,0.0,30,178,5.9,1,,anthony-adkins-1
441,Parker Navarro*,Ohio,MAC,6,25,178,7.1,0,29.7,0,0,,0,0.0,25,178,7.1,0,,parker-navarro-1
442,Aiden Calvert*,Air Force,MWC,13,23,177,7.7,0,13.6,0,0,,0,0.0,23,177,7.7,0,,aiden-calvert-1
443,Jahmyl Jeter*,Texas State,Sun Belt,13,42,176,4.2,9,13.5,1,9,9.0,0,0.7,43,185,4.3,9,,jahmyl-jeter-1
444,Jordan Travis*,Florida State,ACC,11,73,176,2.4,7,16.0,0,0,,0,0.0,73,176,2.4,7,H-5,jordan-travis-1
445,Trey Sanders,TCU,Big 12,12,48,176,3.7,6,14.7,5,20,4.0,0,1.7,53,196,3.7,6,,trey-sanders-2
446,Braylon Braxton,Tulsa,American,6,40,174,4.4,0,29.0,1,7,7.0,0,1.2,41,181,4.4,0,,braylon-braxton-1
447,Henry Rutledge,Charlotte,American,10,15,174,11.6,0,17.4,4,19,4.8,0,1.9,19,193,10.2,0,,henry-rutledge-1
448,Braxton Woodson,Navy,American,4,53,173,3.3,1,43.3,0,0,,0,0.0,53,173,3.3,1,,braxton-woodson-1
449,Brandon Thomas*,Memphis,American,11,46,172,3.7,9,15.6,2,10,5.0,0,0.9,48,182,3.8,9,,brandon-thomas-5
450,Ja'shon Benjamin*,Rutgers,Big Ten,9,45,172,3.8,1,19.1,4,54,13.5,1,6.0,49,226,4.6,2,,jashon-benjamin-1
451,Jeremiah Cobb*,Auburn,SEC,13,33,172,5.2,2,13.2,7,47,6.7,2,3.6,40,219,5.5,4,,jeremiah-cobb-1
452,Jaylen Coleman*,Duke,ACC,10,46,170,3.7,1,17.0,8,57,7.1,0,5.7,54,227,4.2,1,,jaylen-coleman-2
453,Tony Mathis,Houston,Big 12,10,41,170,4.1,0,17.0,11,79,7.2,1,7.9,52,249,4.8,1,,tony-mathis-2
454,Cade Yacamelli*,Wisconsin,Big Ten,9,36,169,4.7,0,18.8,4,23,5.8,0,2.6,40,192,4.8,0,,cade-yacamelli-1
455,Jakobi Buchanan,Army,Ind,12,51,169,3.3,3,14.1,0,0,,0,0.0,51,169,3.3,3,,jakobi-buchanan-1
456,Gi'Bran Payne*,Notre Dame,Ind,13,45,168,3.7,2,12.9,9,58,6.4,2,4.5,54,226,4.2,4,,gibran-payne-1
457,Jacob Zeno,UAB,American,11,91,168,1.8,4,15.3,0,0,,0,0.0,91,168,1.8,4,,jacob-zeno-1
458,Justice Haynes*,Alabama,SEC,13,25,168,6.7,2,12.9,0,0,,0,0.0,25,168,6.7,2,,justice-haynes-1
459,Tyler Lavine*,SMU,American,14,39,168,4.3,7,12.0,7,52,7.4,0,3.7,46,220,4.8,7,,tyler-lavine-1
460,Dominique Johnson,Arkansas,SEC,10,31,167,5.4,1,16.7,2,4,2.0,0,0.4,33,171,5.2,1,,dominique-johnson-2
461,Durell Robinson,Charlotte,American,4,40,166,4.2,1,41.5,1,14,14.0,0,3.5,41,180,4.4,1,,durell-robinson-2
462,Juwuan Price*,Syracuse,ACC,12,47,166,3.5,0,13.8,3,38,12.7,0,3.2,50,204,4.1,0,,juwuan-price-1
463,Brandon Chatman,Navy,American,11,42,165,3.9,0,15.0,19,254,13.4,0,23.1,61,419,6.9,0,,brandon-chatman-1
464,Kaleb Jackson*,LSU,SEC,13,31,165,5.3,4,12.7,6,53,8.8,0,4.1,37,218,5.9,4,,kaleb-jackson-1
465,Tahj Bullock,Akron,MAC,10,62,165,2.7,4,16.5,0,0,,0,0.0,62,165,2.7,4,,tahj-bullock-1
466,Treyaun Webb,Florida,SEC,11,26,163,6.3,2,14.8,4,18,4.5,0,1.6,30,181,6.0,2,,treyaun-webb-1
467,Xavier Townsend*,UCF,Big 12,11,15,163,10.9,0,14.8,33,325,9.8,3,29.5,48,488,10.2,3,,xavier-townsend-1
468,Cash Jones*,Georgia,SEC,14,22,161,7.3,1,11.5,11,92,8.4,1,6.6,33,253,7.7,2,,cash-jones-1
469,Devontae Houston,Connecticut,Ind,4,34,161,4.7,0,40.3,4,59,14.8,1,14.8,38,220,5.8,1,,devontae-houston-1
470,Brendan Sullivan*,Northwestern,Big Ten,8,75,160,2.1,2,20.0,0,0,,0,0.0,75,160,2.1,2,,brendan-sullivan-1
471,Miyan Williams*,Ohio State,Big Ten,6,49,158,3.2,3,26.3,4,42,10.5,0,7.0,53,200,3.8,3,,miyan-williams-1
472,Dillon Bell*,Georgia,SEC,14,25,157,6.3,2,11.2,29,355,12.2,2,25.4,54,512,9.5,4,,dillon-bell-1
473,Lucky Sutton,San Diego State,MWC,5,30,157,5.2,2,31.4,0,0,,0,0.0,30,157,5.2,2,,lucky-sutton-1
474,Cedric Hawkins*,Arkansas State,Sun Belt,8,31,156,5.0,2,19.5,2,32,16.0,0,4.0,33,188,5.7,2,,cedric-hawkins-1
475,Josh McCray,Illinois,Big Ten,5,43,156,3.6,2,31.2,6,30,5.0,0,6.0,49,186,3.8,2,,josh-mccray-1
476,Kelley Joiner Jr.*,South Florida,American,9,39,156,4.0,1,17.3,12,156,13.0,2,17.3,51,312,6.1,3,,kelley-joiner-jr-1
477,Sherod White,New Mexico,MWC,7,37,155,4.2,1,22.1,4,19,4.8,0,2.7,41,174,4.2,1,,sherod-white-1
478,Treyson Potts*,Penn State,Big Ten,13,25,155,6.2,2,11.9,4,57,14.3,1,4.4,29,212,7.3,3,,treyson-potts-1
479,Gio Lopez*,South Alabama,Sun Belt,5,18,154,8.6,2,30.8,0,0,,0,0.0,18,154,8.6,2,,gio-lopez-1
480,Rayshon Luke*,Arizona,Pac-12,13,37,153,4.1,1,11.8,4,95,23.8,0,7.3,41,248,6.0,1,,rayshon-luke-1
481,Keegan Jones*,UCLA,Pac-12,12,14,152,10.9,2,12.7,8,77,9.6,0,6.4,22,229,10.4,2,,keegan-jones-1
482,Keyon Mozee*,Miami (OH),MAC,12,34,151,4.4,2,12.6,0,0,,0,0.0,34,151,4.4,2,,keyon-mozee-1
483,Dylan Paine,Washington State,Pac-12,9,25,150,6.0,1,16.7,1,5,5.0,0,0.6,26,155,6.0,1,,dylan-paine-1
484,Justin Johnson Jr.*,West Virginia,Big 12,9,38,150,3.9,1,16.7,2,4,2.0,0,0.4,40,154,3.9,1,,justin-johnson-jr-1
485,Shaadie Clayton-Johnson*,Tulane,American,10,41,150,3.7,0,15.0,10,87,8.7,0,8.7,51,237,4.6,0,,shaadie-clayton-1
486,Keldric Moody,Louisiana Tech,CUSA,10,34,149,4.4,0,14.9,7,53,7.6,0,5.3,41,202,4.9,0,,keldric-moody-1
487,Tyler Shough*,Texas Tech,Big 12,4,48,149,3.1,2,37.3,0,0,,0,0.0,48,149,3.1,2,,tyler-shough-1
488,Barion Brown*,Kentucky,SEC,13,12,147,12.3,1,11.3,43,539,12.5,4,41.5,55,686,12.5,5,,barion-brown-1
489,Jaylen Anderson*,West Virginia,Big 12,7,44,147,3.3,1,21.0,4,42,10.5,0,6.0,48,189,3.9,1,,jaylen-anderson-2
490,Djouvensky Schlenbaker,Washington State,Pac-12,12,33,146,4.4,0,12.2,5,32,6.4,1,2.7,38,178,4.7,1,,djouvensky-schlenbaker-1
491,Noah Whittington*,Oregon,Pac-12,4,20,146,7.3,2,36.5,10,78,7.8,0,19.5,30,224,7.5,2,,noah-whittington-1
492,Terry Wilkins,Middle Tennessee State,CUSA,7,18,146,8.1,1,20.9,2,3,1.5,0,0.4,20,149,7.5,1,,terry-wilkins-1
493,Cameron Ward,Washington State,Pac-12,12,120,144,1.2,8,12.0,0,0,,0,0.0,120,144,1.2,8,,cameron-ward-1
494,Joachim Bangda,Charlotte,American,11,42,143,3.4,4,13.0,5,46,9.2,0,4.2,47,189,4.0,4,,joachim-bangda-1
495,Caleb Williams*,USC,Pac-12,12,97,142,1.5,11,11.8,1,15,15.0,0,1.3,98,157,1.6,11,,caleb-williams-3
496,Elijah Collins*,Oklahoma State,Big 12,10,30,142,4.7,2,14.2,2,19,9.5,0,1.9,32,161,5.0,2,,elijah-collins-1
497,Kevin Jennings*,SMU,American,8,37,142,3.8,1,17.8,0,0,,0,0.0,37,142,3.8,1,,kevin-jennings-2
498,Brett Gabbert*,Miami (OH),MAC,8,49,140,2.9,2,17.5,0,0,,0,0.0,49,140,2.9,2,,brett-gabbert-1
499,Jovantae Barnes*,Oklahoma,Big 12,7,37,140,3.8,1,20.0,5,23,4.6,0,3.3,42,163,3.9,1,,jovantae-barnes-1
500,Michael Johnson Jr.,Florida Atlantic,American,10,23,140,6.1,7,14.0,0,0,,0,0.0,23,140,6.1,7,,michael-johnson-jr-1
501,Demie Sumo*,Kentucky,SEC,13,20,139,7.0,1,10.7,14,69,4.9,1,5.3,34,208,6.1,2,,demie-sumo-1
502,Vaughn Pemberton,Ball State,MAC,6,23,139,6.0,1,23.2,7,31,4.4,1,5.2,30,170,5.7,2,,vaughn-pemberton-1
503,Arnold Barnes III*,Tulane,American,7,23,138,6.0,0,19.7,0,0,,0,0.0,23,138,6.0,0,,arnold-barnes-iii-1
504,David Cordero,Hawaii,MWC,9,32,138,4.3,0,15.3,5,24,4.8,0,2.7,37,162,4.4,0,,david-cordero-1
505,Jutahn McClain*,Kentucky,SEC,11,26,138,5.3,1,12.5,3,16,5.3,0,1.5,29,154,5.3,1,,jutahn-mcclain-1
506,L.T. Sanders*,Western Kentucky,CUSA,10,31,138,4.5,0,13.8,8,68,8.5,0,6.8,39,206,5.3,0,,lt-sanders-1
507,Jordan Brunson*,Miami (OH),MAC,6,12,137,11.4,1,22.8,0,0,,0,0.0,12,137,11.4,1,,jordan-brunson-2
508,Velton Gardner*,SMU,American,10,32,137,4.3,1,13.7,1,7,7.0,0,0.7,33,144,4.4,1,,velton-gardner-1
509,Xavier Williams,Kent State,MAC,12,42,137,3.3,1,11.4,1,1,1.0,0,0.1,43,138,3.2,1,,xavier-williams-2
510,Joseph Himon II*,Northwestern,Big Ten,13,35,136,3.9,0,10.5,18,219,12.2,1,16.8,53,355,6.7,1,,joseph-himon-ii-1
511,Austin Smith*,Eastern Michigan,MAC,12,101,134,1.3,2,11.2,0,0,,0,0.0,101,134,1.3,2,,austin-smith-5
512,Daniel Carter,Pitt,ACC,12,28,134,4.8,2,11.2,3,4,1.3,0,0.3,31,138,4.5,2,,daniel-carter-1
513,Keilan Robinson*,Texas,Big 12,13,12,134,11.2,3,10.3,8,56,7.0,0,4.3,20,190,9.5,3,,keilan-robinson-1
514,Rickey Hunt*,Ohio,MAC,3,23,134,5.8,4,44.7,2,21,10.5,1,7.0,25,155,6.2,5,,rickey-hunt-1
515,Nicco Marchiol*,West Virginia,Big 12,9,38,133,3.5,1,14.8,0,0,,0,0.0,38,133,3.5,1,,nicco-marchiol-1
516,Brashard Smith*,Miami (FL),ACC,12,9,132,14.7,1,11.0,22,263,12.0,2,21.9,31,395,12.7,3,,brashard-smith-1
517,CJ Hester,Western Michigan,MAC,8,28,132,4.7,2,16.5,1,2,2.0,0,0.3,29,134,4.6,2,,cj-hester-1
518,Drake Anderson,Akron,MAC,12,40,132,3.3,1,11.0,17,93,5.5,1,7.8,57,225,3.9,2,,drake-anderson-1
519,Latrele Palmer*,James Madison,Sun Belt,9,33,132,4.0,1,14.7,2,16,8.0,0,1.8,35,148,4.2,1,,latrele-palmer-1
520,Quincy Patterson,Temple,American,10,41,132,3.2,4,13.2,0,0,,0,0.0,41,132,3.2,4,,quincy-patterson-1
521,Savion Red*,Texas,Big 12,12,30,131,4.4,1,10.9,0,0,,0,0.0,30,131,4.4,1,,savion-red-1
522,Josh Fleeks,Nebraska,Big Ten,10,17,130,7.6,1,13.0,8,69,8.6,0,6.9,25,199,8.0,1,,josh-fleeks-1
523,Andrew Paul*,Georgia,SEC,7,29,129,4.4,1,18.4,2,14,7.0,1,2.0,31,143,4.6,2,,andrew-paul-1
524,Ja'Vin Simpkins*,Coastal Carolina,Sun Belt,11,21,129,6.1,1,11.7,1,3,3.0,0,0.3,22,132,6.0,1,,javin-simpkins-1
525,Rocky Lombardi*,Northern Illinois,MAC,13,72,129,1.8,7,9.9,0,0,,0,0.0,72,129,1.8,7,,rocky-lombardi-1
526,Jaison Patterson*,Bowling Green,MAC,13,35,128,3.7,1,9.8,4,23,5.8,0,1.8,39,151,3.9,1,,jaison-patterson-1
527,Kobe Johnson,Colorado State,MWC,4,44,128,2.9,1,32.0,4,32,8.0,0,8.0,48,160,3.3,1,,kobe-johnson-1
528,Mitch Griffis,Wake Forest,ACC,9,106,128,1.2,2,14.2,0,0,,0,0.0,106,128,1.2,2,,mitch-griffis-1
529,Ethan Garbers*,UCLA,Pac-12,11,35,127,3.6,0,11.5,1,5,5.0,0,0.5,36,132,3.7,0,,ethan-garbers-1
530,Quinten Joyner*,USC,Pac-12,6,18,125,6.9,1,20.8,1,7,7.0,0,1.2,19,132,6.9,1,,quinten-joyner-1
531,Dylan Hopkins,New Mexico,MWC,11,51,124,2.4,1,11.3,0,0,,0,0.0,51,124,2.4,1,,dylan-hopkins-1
532,Pasean Wimberly*,Bowling Green,MAC,13,22,124,5.6,1,9.5,0,0,,0,0.0,22,124,5.6,1,,pasean-wimberly-1
533,Bryce Williams*,Minnesota,Big Ten,4,36,123,3.4,1,30.8,4,31,7.8,0,7.8,40,154,3.9,1,,bryce-williams-4
534,Dorian Lewis,New Mexico,MWC,5,24,123,5.1,0,24.6,2,10,5.0,0,2.0,26,133,5.1,0,,dorian-lewis-1
535,Sam Hartman*,Notre Dame,Ind,12,45,123,2.7,3,10.3,0,-4,,0,-0.3,45,119,2.6,3,,sam-hartman-1
536,Cooper Legas*,Utah State,MWC,9,68,122,1.8,0,13.6,0,0,,0,0.0,68,122,1.8,0,,cooper-legas-1
537,Adrian Murdaugh,Sam Houston,CUSA,8,26,121,4.7,2,15.1,8,40,5.0,0,5.0,34,161,4.7,2,,adrian-murdaugh-1
538,Jayden De Laura*,Arizona,Pac-12,7,21,121,5.8,3,17.3,0,0,,0,0.0,21,121,5.8,3,,jayden-de-laura-1
539,John Emery Jr.*,LSU,SEC,7,23,121,5.3,1,17.3,3,58,19.3,0,8.3,26,179,6.9,1,,john-emery-jr-1
540,Dakereon Joyner,South Carolina,SEC,10,50,120,2.4,5,12.0,21,117,5.6,0,11.7,71,237,3.3,5,,dakereon-joyner-1
541,Maddux Madsen*,Boise State,MWC,9,33,120,3.6,2,13.3,0,0,,0,0.0,33,120,3.6,2,,maddux-madsen-1
542,Ta'Quan Roberson,Connecticut,Ind,11,46,120,2.6,2,10.9,0,-1,,1,-0.1,46,119,2.6,3,,taquan-roberson-1
543,Tyson Riley,Army,Ind,12,15,119,7.9,1,9.9,5,38,7.6,3,3.2,20,157,7.9,4,,tyson-riley-1
544,Willie Shaw III*,Toledo,MAC,6,31,118,3.8,0,19.7,1,5,5.0,0,0.8,32,123,3.8,0,,willie-shaw-iii-1
545,CJ Campbell*,Florida State,ACC,10,7,117,16.7,1,11.7,0,0,,0,0.0,7,117,16.7,1,,cj-campbell-1
546,Luke McCaffrey*,Rice,American,13,15,117,7.8,0,9.0,71,992,14.0,13,76.3,86,1109,12.9,13,,luke-mccaffrey-1
547,Carson Beck*,Georgia,SEC,14,60,116,1.9,4,8.3,0,0,,0,0.0,60,116,1.9,4,,carson-beck-1
548,Domonique Thomas*,Clemson,ACC,12,18,116,6.4,1,9.7,1,4,4.0,0,0.3,19,120,6.3,1,,domonique-thomas-1
549,Jackson Arnold*,Oklahoma,Big 12,7,31,116,3.7,1,16.6,0,0,,0,0.0,31,116,3.7,1,,jackson-arnold-1
550,Jake Retzlaff,BYU,Big 12,4,51,116,2.3,3,29.0,0,0,,0,0.0,51,116,2.3,3,,jake-retzlaff-1
551,Vaughn Blue*,Liberty,CUSA,6,19,116,6.1,0,19.3,4,26,6.5,1,4.3,23,142,6.2,1,,vaughn-blue-1
552,Asa Martin*,Troy,Sun Belt,14,25,114,4.6,0,8.1,11,82,7.5,1,5.9,36,196,5.4,1,,asa-martin-1
553,Jamaal Bell,Nevada,MWC,12,32,114,3.6,1,9.5,32,262,8.2,1,21.8,64,376,5.9,2,,jamaal-bell-1
554,Sedrick Irvin,Stanford,Pac-12,8,26,113,4.3,1,14.1,2,9,4.5,0,1.1,28,122,4.4,1,,sedrick-irvin-2
555,David Mbadinga*,Georgia Southern,Sun Belt,11,22,112,5.1,2,10.2,6,30,5.0,0,2.7,28,142,5.1,2,,david-mbadinga-1
556,A.J. Henning*,Northwestern,Big Ten,12,27,110,4.1,1,9.2,45,418,9.3,4,34.8,72,528,7.3,5,,aj-henning-1
557,Dallan Hayden*,Ohio State,Big Ten,3,19,110,5.8,1,36.7,1,-2,-2.0,0,-0.7,20,108,5.4,1,,dallan-hayden-1
558,Jaivian Thomas*,California,Pac-12,8,18,110,6.1,1,13.8,3,24,8.0,1,3.0,21,134,6.4,2,,jaivian-thomas-1
559,Trey Holly*,LSU,SEC,3,11,110,10.0,1,36.7,1,5,5.0,0,1.7,12,115,9.6,1,,trey-holly-1
560,Jayden Limar*,Oregon,Pac-12,11,24,109,4.5,1,9.9,7,61,8.7,0,5.5,31,170,5.5,1,,jayden-limar-1
561,Jayden McGowan,Vanderbilt,SEC,12,18,109,6.1,0,9.1,36,383,10.6,0,31.9,54,492,9.1,0,,jayden-mcgowan-1
562,Eli Stowers*,New Mexico State,CUSA,15,28,108,3.9,2,7.2,35,366,10.5,2,24.4,63,474,7.5,4,,eli-stowers-1
563,Cameron Seldon*,Tennessee,SEC,13,25,106,4.2,0,8.2,0,0,,0,0.0,25,106,4.2,0,,cameron-seldon-1
564,D.Q. James*,Wyoming,MWC,4,35,106,3.0,0,26.5,2,14,7.0,0,3.5,37,120,3.2,0,,dq-james-1
565,Kyson Brown,Arizona State,Pac-12,12,23,106,4.6,0,8.8,9,49,5.4,0,4.1,32,155,4.8,0,,kyson-brown-1
566,Carlos Del Rio-Wilson*,Syracuse,ACC,7,21,105,5.0,1,15.0,0,0,,0,0.0,21,105,5.0,1,,carlos-del-rio-wilson-1
567,Damarius Good*,Texas State,Sun Belt,9,11,105,9.5,0,11.7,0,0,,0,0.0,11,105,9.5,0,,damarius-good-1
568,Jacob Fields,Louisiana Tech,CUSA,11,26,105,4.0,2,9.5,12,97,8.1,0,8.8,38,202,5.3,2,,jacob-fields-1
569,Leo Pulalasi,Washington State,Pac-12,2,18,105,5.8,0,52.5,2,14,7.0,0,7.0,20,119,6.0,0,,leo-pulalasi-1
570,Jaylen Henderson*,Texas A&M,SEC,5,41,104,2.5,2,20.8,0,0,,0,0.0,41,104,2.5,2,,jaylen-henderson-1
571,Spencer Rattler,South Carolina,SEC,12,97,104,1.1,4,8.7,0,0,,0,0.0,97,104,1.1,4,,spencer-rattler-1
572,Timmy Mcclain*,UCF,Big 12,7,42,104,2.5,1,14.9,0,0,,1,0.0,42,104,2.5,2,,timmy-mcclain-1
573,Ike Daniels*,Syracuse,ACC,4,18,103,5.7,0,25.8,3,19,6.3,0,4.8,21,122,5.8,0,,ike-daniels-1
574,Martin Blake,San Diego State,MWC,12,28,103,3.7,1,8.6,10,115,11.5,0,9.6,38,218,5.7,1,,martin-blake-1
575,Walter Taylor,Vanderbilt,SEC,5,30,103,3.4,1,20.6,0,0,,0,0.0,30,103,3.4,1,,walter-taylor-3
576,Ashton Hayes,Nevada,MWC,4,30,102,3.4,0,25.5,5,10,2.0,0,2.5,35,112,3.2,0,,ashton-hayes-1
577,Charles Norman,Louisiana-Monroe,Sun Belt,12,24,102,4.3,0,8.5,0,0,,0,0.0,24,102,4.3,0,,charles-norman-1
578,Noah Smith,Sam Houston,CUSA,12,27,102,3.8,2,8.5,79,782,9.9,6,65.2,106,884,8.3,8,,noah-smith-3
579,DJ Riles,Middle Tennessee State,CUSA,12,19,101,5.3,1,8.4,4,58,14.5,1,4.8,23,159,6.9,2,,dj-riles-1
580,Gerald Green,East Carolina,American,8,25,101,4.0,2,12.6,8,38,4.8,0,4.8,33,139,4.2,2,,gerald-green-5
581,Shedro Louis*,Tulane,American,14,34,101,3.0,0,7.2,5,47,9.4,0,3.4,39,148,3.8,0,,shedro-louis-1
582,Zane Minors*,SMU,American,7,24,101,4.2,0,14.4,0,0,,0,0.0,24,101,4.2,0,,zane-minors-1
583,Austin Reed*,Western Kentucky,CUSA,12,42,100,2.4,4,8.3,0,0,,0,0.0,42,100,2.4,4,,austin-reed-2
584,Calvin Hill*,Texas State,Sun Belt,7,31,98,3.2,0,14.0,4,28,7.0,0,4.0,35,126,3.6,0,,calvin-hill-4
585,Aaron Turner,Cincinnati,Big 12,12,11,97,8.8,0,8.1,11,89,8.1,2,7.4,22,186,8.5,2,,aaron-turner-2
586,David Bailey*,Texas A&M,SEC,12,20,97,4.9,1,8.1,1,16,16.0,0,1.3,21,113,5.4,1,,david-bailey-4
587,AJ Newberry,Vanderbilt,SEC,4,20,96,4.8,0,24.0,0,0,,0,0.0,20,96,4.8,0,,aj-newberry-1
588,Ethan Crawford,Southern Mississippi,Sun Belt,6,42,96,2.3,1,16.0,0,0,,0,0.0,42,96,2.3,1,,ethan-crawford-2
589,Jamal Johnson*,Bowling Green,MAC,11,15,96,6.4,0,8.7,3,13,4.3,0,1.2,18,109,6.1,0,,jamal-johnson-2
590,Jordan Houston*,North Carolina State,ACC,3,25,96,3.8,0,32.0,3,-3,-1.0,0,-1.0,28,93,3.3,0,,jordan-houston-1
591,Jordan Younge-Humphrey*,Nevada-Las Vegas,MWC,5,12,96,8.0,1,19.2,0,0,,0,0.0,12,96,8.0,1,,jordan-younge-humphrey-1
592,Kevin Davis*,Miami (OH),MAC,13,25,96,3.8,1,7.4,15,167,11.1,1,12.8,40,263,6.6,2,,kevin-davis-8
593,Rico Barfield,Ball State,MAC,12,25,96,3.8,1,8.0,6,88,14.7,1,7.3,31,184,5.9,2,,rico-barfield-1
594,Jalil Farooq*,Oklahoma,Big 12,13,17,95,5.6,0,7.3,45,694,15.4,2,53.4,62,789,12.7,2,,jalil-farooq-1
595,Sean Jackson*,Auburn,SEC,11,6,95,15.8,1,8.6,0,0,,0,0.0,6,95,15.8,1,,sean-jackson-3
596,Aaron Young*,Rutgers,Big Ten,9,16,94,5.9,1,10.4,3,24,8.0,2,2.7,19,118,6.2,3,,aaron-young-5
597,Athan Kaliakmanis*,Minnesota,Big Ten,12,74,94,1.3,2,7.8,0,0,,0,0.0,74,94,1.3,2,,athan-kaliakmanis-1
598,Anthony Simpson,Massachusetts,Ind,12,11,93,8.5,1,7.8,57,792,13.9,3,66.0,68,885,13.0,4,,anthony-simpson-2
599,Jacques Badolato-Birdsell,Nevada,MWC,9,37,93,2.5,1,10.3,2,16,8.0,0,1.8,39,109,2.8,1,,jacques-badolato-birdsell-1
600,Jalen Berger,Michigan State,Big Ten,5,25,93,3.7,1,18.6,5,40,8.0,0,8.0,30,133,4.4,1,,jalen-berger-1
601,Kamari Moulton*,Iowa,Big Ten,4,27,93,3.4,2,23.3,0,0,,0,0.0,27,93,3.4,2,,kamari-moulton-1
602,Tylan Hines,Hawaii,MWC,4,27,93,3.4,0,23.3,7,26,3.7,0,6.5,34,119,3.5,0,,tylan-hines-1
603,Zach Hrbacek,Sam Houston,CUSA,5,37,93,2.5,0,18.6,7,43,6.1,0,8.6,44,136,3.1,0,,zach-hrbacek-1
604,Fernando Mendoza*,California,Pac-12,9,48,92,1.9,2,10.2,0,0,,0,0.0,48,92,1.9,2,,fernando-mendoza-1
605,Jalin Conyers,Arizona State,Pac-12,11,22,92,4.2,1,8.4,30,362,12.1,0,32.9,52,454,8.7,1,,jalin-conyers-1
606,John Mateer,Washington State,Pac-12,11,21,92,4.4,3,8.4,2,14,7.0,0,1.3,23,106,4.6,3,,john-mateer-1
607,Ari Broussard*,Rice,American,13,29,91,3.1,0,7.0,2,14,7.0,0,1.1,31,105,3.4,0,,ari-broussard-1
608,Billy Edwards Jr.*,Maryland,Big Ten,8,29,91,3.1,7,11.4,0,0,,0,0.0,29,91,3.1,7,,billy-edwards-jr-1
609,Justin Williams-Thomas*,California,Pac-12,6,21,91,4.3,0,15.2,1,7,7.0,0,1.2,22,98,4.5,0,,justin-williams-thomas-1
610,Dante Dowdell*,Oregon,Pac-12,6,17,90,5.3,1,15.0,0,0,,0,0.0,17,90,5.3,1,,dante-dowdell-1
611,Nasjzae Bryant,Hawaii,MWC,7,26,89,3.4,0,12.7,1,-3,-3.0,0,-0.4,27,86,3.2,0,,nasjzae-bryant-1
612,Tommy Ulatowski,Kent State,MAC,10,47,89,1.9,1,8.9,0,0,,0,0.0,47,89,1.9,1,,tommy-ulatowski-1
613,Cole Snyder,Buffalo,MAC,12,67,88,1.3,1,7.3,0,0,,0,0.0,67,88,1.3,1,,cole-snyder-2
614,Justin Lynch*,Northern Illinois,MAC,5,13,88,6.8,1,17.6,0,0,,0,0.0,13,88,6.8,1,,justin-lynch-1
615,Harrison Barker,UAB,American,4,15,87,5.8,0,21.8,0,0,,0,0.0,15,87,5.8,0,,harrison-barker-1
616,Rodney Gallagher*,West Virginia,Big 12,13,15,87,5.8,0,6.7,10,74,7.4,0,5.7,25,161,6.4,0,,rodney-gallagher-1
617,Alex Orji*,Michigan,Big Ten,6,15,86,5.7,1,14.3,0,0,,0,0.0,15,86,5.7,1,,alex-orji-1
618,Isaac Jernagin*,San Jose State,MWC,13,12,86,7.2,0,6.6,13,133,10.2,2,10.2,25,219,8.8,2,,isaac-jernagin-2
619,Ty Simpson*,Alabama,SEC,6,14,86,6.1,2,14.3,0,0,,0,0.0,14,86,6.1,2,,ty-simpson-1
620,Jekail Middlebrook,Middle Tennessee State,CUSA,4,18,85,4.7,2,21.3,4,31,7.8,0,7.8,22,116,5.3,2,,jekail-middlebrook-1
621,Ryan Browne,Purdue,Big Ten,1,21,85,4.0,0,85.0,0,0,,0,0.0,21,85,4.0,0,,ryan-browne-1
622,Silas Bolden*,Oregon State,Pac-12,13,9,84,9.3,2,6.5,54,746,13.8,5,57.4,63,830,13.2,7,,silas-bolden-1
623,Colson Yankoff*,UCLA,Pac-12,13,13,83,6.4,1,6.4,2,-5,-2.5,0,-0.4,15,78,5.2,1,,colson-yankoff-1
624,Chase Jenkins*,Rice,American,5,14,82,5.9,1,16.4,0,0,,0,0.0,14,82,5.9,1,,chase-jenkins-1
625,Aidan Laughery,Illinois,Big Ten,9,16,81,5.1,1,9.0,2,24,12.0,0,2.7,18,105,5.8,1,,aidan-laughery-1
626,Cade Harris*,Air Force,MWC,13,11,81,7.4,2,6.2,5,179,35.8,1,13.8,16,260,16.3,3,,cade-harris-1
627,Darwin Barlow*,USC,Pac-12,8,8,81,10.1,1,10.1,1,10,10.0,0,1.3,9,91,10.1,1,,darwin-barlow-1
628,Jaren Mangham,Michigan State,Big Ten,6,30,81,2.7,0,13.5,7,37,5.3,0,6.2,37,118,3.2,0,,jaren-mangham-1
629,Brady Lichtenberg,Cincinnati,Big 12,7,12,80,6.7,1,11.4,0,0,,0,0.0,12,80,6.7,1,,brady-lichtenberg-1
630,Evan Svoboda*,Wyoming,MWC,10,25,80,3.2,2,8.0,0,0,,0,0.0,25,80,3.2,2,,evan-svoboda-1
631,Jack Lausch*,Northwestern,Big Ten,10,19,80,4.2,1,8.0,2,9,4.5,0,0.9,21,89,4.2,1,,jack-lausch-1
632,Larry Robinson,Army,Ind,2,6,80,13.3,1,40.0,0,0,,0,0.0,6,80,13.3,1,,larry-robinson-2
633,Aidan Chiles*,Oregon State,Pac-12,9,17,79,4.6,3,8.8,0,0,,0,0.0,17,79,4.6,3,,aidan-chiles-1
634,Matt Jones*,Ole Miss,SEC,12,12,79,6.6,2,6.6,1,-1,-1.0,0,-0.1,13,78,6.0,2,,matt-jones-9
635,Brandon Buckhaulter,UAB,American,11,7,78,11.1,0,7.1,5,103,20.6,1,9.4,12,181,15.1,1,,brandon-buckhaulter-1
636,Isaiah Newell*,Oregon State,Pac-12,13,25,78,3.1,0,6.0,0,0,,0,0.0,25,78,3.1,0,,isaiah-newell-1
637,Miles Davis,BYU,Big 12,5,16,78,4.9,0,15.6,1,-7,-7.0,0,-1.4,17,71,4.2,0,,miles-davis-1
638,Markel Johnson,Army,Ind,11,22,77,3.5,0,7.0,2,41,20.5,0,3.7,24,118,4.9,0,,markel-johnson-2
639,Caden Veltkamp*,Western Kentucky,CUSA,3,23,76,3.3,0,25.3,0,0,,0,0.0,23,76,3.3,0,,caden-veltkamp-1
640,Micah Bernard*,Utah,Pac-12,2,16,76,4.8,1,38.0,5,30,6.0,0,15.0,21,106,5.0,1,,micah-bernard-1
641,Cole Ballard*,Kansas,Big 12,4,20,75,3.8,0,18.8,0,0,,0,0.0,20,75,3.8,0,,cole-ballard-1
642,Grant Wells*,Virginia Tech,ACC,6,17,75,4.4,1,12.5,0,0,,0,0.0,17,75,4.4,1,,grant-wells-1
643,Keyvone Lee,Mississippi State,SEC,8,12,75,6.3,0,9.4,0,0,,0,0.0,12,75,6.3,0,,keyvone-lee-1
644,PJ Martin*,South Alabama,Sun Belt,4,12,75,6.3,1,18.8,2,24,12.0,0,6.0,14,99,7.1,1,,pj-martin-1
645,Quinn Ewers*,Texas,Big 12,12,59,75,1.3,5,6.3,1,3,3.0,0,0.3,60,78,1.3,5,,quinn-ewers-1
646,Jalon Daniels*,Kansas,Big 12,3,27,74,2.7,0,24.7,0,0,,0,0.0,27,74,2.7,0,,jalon-daniels-1
647,Lideatrick Griffin,Mississippi State,SEC,12,17,74,4.4,1,6.2,50,658,13.2,4,54.8,67,732,10.9,5,,lideatrick-griffin-1
648,Ben Wooldridge*,Louisiana,Sun Belt,3,17,73,4.3,2,24.3,0,0,,0,0.0,17,73,4.3,2,,ben-wooldridge-1
649,Chris Johnson Jr.*,Miami (FL),ACC,4,11,73,6.6,1,18.3,1,2,2.0,0,0.5,12,75,6.3,1,,chris-johnson-jr-1
650,Tre Wisner*,Texas,Big 12,14,12,73,6.1,1,5.2,0,0,,0,0.0,12,73,6.1,1,,tre-wisner-1
651,Xayvion Turner-Bradshaw*,Virginia Tech,ACC,10,4,73,18.3,1,7.3,1,9,9.0,0,0.9,5,82,16.4,1,,xayvion-turner-bradshaw-1
652,Jalen Mitchell,Connecticut,Ind,11,22,72,3.3,0,6.5,6,41,6.8,0,3.7,28,113,4.0,0,,jalen-mitchell-1
653,Kenny Johnson,Pitt,ACC,12,10,72,7.2,0,6.0,15,122,8.1,1,10.2,25,194,7.8,1,,kenny-johnson-3
654,Terrence Williams*,Louisiana,Sun Belt,5,23,72,3.1,1,14.4,1,-2,-2.0,0,-0.4,24,70,2.9,1,,terrence-williams-1
655,Charlie Spegal,Ball State,MAC,12,15,71,4.7,1,5.9,1,7,7.0,0,0.6,16,78,4.9,1,,charlie-spegal-1
656,Nico Iamaleava*,Tennessee,SEC,5,20,71,3.6,3,14.2,0,0,,0,0.0,20,71,3.6,3,,nico-iamaleava-1
657,Peyton Jones*,Duke,ACC,13,20,71,3.6,1,5.5,0,0,,0,0.0,20,71,3.6,1,,peyton-jones-3
658,Sammy Malignaggi*,James Madison,Sun Belt,11,13,71,5.5,0,6.5,0,0,,0,0.0,13,71,5.5,0,,sammy-malignaggi-1
659,Tank Smith*,Penn State,Big Ten,3,9,71,7.9,0,23.7,0,0,,0,0.0,9,71,7.9,0,,tank-smith-1
660,Stone Earle,North Texas,American,4,16,70,4.4,0,17.5,0,0,,0,0.0,16,70,4.4,0,,stone-earle-1
661,Zachariah Branch*,USC,Pac-12,11,9,70,7.8,1,6.4,31,320,10.3,2,29.1,40,390,9.8,3,,zachariah-branch-1
662,Benjamin Hall*,Michigan,Big Ten,3,15,69,4.6,0,23.0,1,0,0.0,0,0.0,16,69,4.3,0,,benjamin-hall-1
663,Bryce Duke*,Virginia Tech,ACC,12,11,69,6.3,0,5.8,2,19,9.5,0,1.6,13,88,6.8,0,,bryce-duke-1
664,Jarris Williams*,Troy,Sun Belt,10,14,69,4.9,1,6.9,1,0,0.0,0,0.0,15,69,4.6,1,,jarris-williams-1
665,Nate Milanowski*,Miami (OH),MAC,2,11,69,6.3,1,34.5,0,0,,0,0.0,11,69,6.3,1,,nate-milanowski-1
666,Sawyer Robertson,Baylor,Big 12,6,35,69,2.0,1,11.5,0,0,,0,0.0,35,69,2.0,1,,sawyer-robertson-1
667,TJ Finley*,Texas State,Sun Belt,13,78,69,0.9,5,5.3,0,0,,0,0.0,78,69,0.9,5,,tj-finley-1
668,Hunter Herring,Louisiana-Monroe,Sun Belt,2,13,68,5.2,0,34.0,0,0,,0,0.0,13,68,5.2,0,,hunter-herring-1
669,Larenzo McMillan*,New Mexico State,CUSA,2,5,68,13.6,0,34.0,1,-3,-3.0,0,-1.5,6,65,10.8,0,,larenzo-mcmillan-1
670,Nehemiah Martinez*,Texas Tech,Big 12,11,13,68,5.2,0,6.2,2,32,16.0,0,2.9,15,100,6.7,0,,nehemiah-martinez-1
671,Trenton Bourguet,Arizona State,Pac-12,8,26,68,2.6,2,8.5,1,18,18.0,0,2.3,27,86,3.2,2,,trenton-bourguet-1
672,Carson Hansen*,Iowa State,Big 12,13,22,67,3.0,0,5.2,11,115,10.5,0,8.8,33,182,5.5,0,,carson-hansen-1
673,Kamarro Edmonds,East Carolina,American,7,14,67,4.8,2,9.6,1,3,3.0,0,0.4,15,70,4.7,2,,kamarro-edmonds-1
674,Sam Leavitt,Michigan State,Big Ten,4,13,67,5.2,0,16.8,0,0,,0,0.0,13,67,5.2,0,,sam-leavitt-1
675,Semaj Morgan*,Michigan,Big Ten,15,4,67,16.8,2,4.5,22,204,9.3,2,13.6,26,271,10.4,4,,semaj-morgan-1
676,Trent Pennix*,North Carolina State,ACC,12,2,67,33.5,1,5.6,15,190,12.7,3,15.8,17,257,15.1,4,,trent-pennix-1
677,Tony Muskett,Virginia,ACC,6,61,66,1.1,1,11.0,0,0,,0,0.0,61,66,1.1,1,,tony-muskett-1
678,Ahmani Marshall*,Appalachian State,Sun Belt,14,20,65,3.3,2,4.6,0,0,,0,0.0,20,65,3.3,2,,ahmani-marshall-1
679,Keyjuan Brown*,Louisville,ACC,1,11,65,5.9,1,65.0,0,0,,0,0.0,11,65,5.9,1,,keyjuan-brown-1
680,Marlon Gunn Jr.,East Carolina,American,11,24,65,2.7,0,5.9,5,34,6.8,0,3.1,29,99,3.4,0,,marlon-gunn-jr-1
681,Rahmir Johnson,Nebraska,Big Ten,3,12,65,5.4,0,21.7,3,9,3.0,0,3.0,15,74,4.9,0,,rahmir-johnson-1
682,Treyson Bourguet,Western Michigan,MAC,6,36,65,1.8,0,10.8,0,0,,0,0.0,36,65,1.8,0,,treyson-bourguet-1
683,Deion Smith,BYU,Big 12,10,23,64,2.8,1,6.4,10,65,6.5,1,6.5,33,129,3.9,2,,deion-smith-1
684,Yulkeith Brown*,Tulane,American,13,6,64,10.7,2,4.9,33,391,11.8,2,30.1,39,455,11.7,4,,yulkeith-brown-1
685,Brayden Schager,Hawaii,MWC,13,103,63,0.6,2,4.8,0,0,,0,0.0,103,63,0.6,2,,brayden-schager-1
686,Cam'Ron McCoy*,Eastern Michigan,MAC,3,15,63,4.2,1,21.0,0,0,,0,0.0,15,63,4.2,1,,camron-mccoy-1
687,Conner Weigman*,Texas A&M,SEC,4,12,63,5.3,2,15.8,0,0,,0,0.0,12,63,5.3,2,,conner-weigman-1
688,Gunner Stockton*,Georgia,SEC,4,11,63,5.7,0,15.8,0,0,,0,0.0,11,63,5.7,0,,gunner-stockton-1
689,Jack Turner,Louisiana Tech,CUSA,8,29,63,2.2,2,7.9,0,0,,0,0.0,29,63,2.2,2,,jack-turner-1
690,Juju McDowell,South Carolina,SEC,10,26,63,2.4,2,6.3,11,105,9.5,1,10.5,37,168,4.5,3,,juju-mcdowell-1
691,Rocco Becht*,Iowa State,Big 12,13,62,63,1.0,3,4.8,0,0,,0,0.0,62,63,1.0,3,,rocco-becht-1
692,Solo Vaipulu,Hawaii,MWC,13,12,63,5.3,0,4.8,9,76,8.4,0,5.8,21,139,6.6,0,,solo-vaipulu-1
693,Bryce Farrell,Stanford,Pac-12,12,21,62,3.0,3,5.2,22,192,8.7,1,16.0,43,254,5.9,4,,bryce-farrell-1
694,Chase Gillespie,Vanderbilt,SEC,12,22,62,2.8,0,5.2,5,28,5.6,0,2.3,27,90,3.3,0,,chase-gillespie-1
695,Demarkcus Bowman*,UCF,Big 12,3,10,62,6.2,1,20.7,2,7,3.5,0,2.3,12,69,5.8,1,,demarkcus-bowman-1
696,Keshawn King,Western Michigan,MAC,4,14,62,4.4,1,15.5,2,27,13.5,0,6.8,16,89,5.6,1,,keshawn-king-1
697,Ricky Pearsall,Florida,SEC,12,3,62,20.7,2,5.2,65,965,14.8,4,80.4,68,1027,15.1,6,,ricky-pearsall-1
698,Savion Williams,TCU,Big 12,11,11,62,5.6,0,5.6,41,573,14.0,4,52.1,52,635,12.2,4,,savion-williams-2
699,Sevion Morrison*,Kansas,Big 12,5,10,62,6.2,1,12.4,2,17,8.5,0,3.4,12,79,6.6,1,,sevion-morrison-1
700,Zuberi Mobley,Florida Atlantic,American,3,22,62,2.8,0,20.7,1,7,7.0,0,2.3,23,69,3.0,0,,zuberi-mobley-1
701,Jake Strong*,Texas Tech,Big 12,3,6,61,10.2,0,20.3,0,0,,0,0.0,6,61,10.2,0,,jake-strong-1
702,Jaylen Jenkins,Washington State,Pac-12,6,20,61,3.1,0,10.2,6,61,10.2,0,10.2,26,122,4.7,0,,jaylen-jenkins-1
703,KZ Adams*,Georgia State,Sun Belt,6,35,61,1.7,0,10.2,1,3,3.0,0,0.5,36,64,1.8,0,,kz-adams-1
704,Creed Whittemore,Mississippi State,SEC,12,4,60,15.0,1,5.0,11,102,9.3,2,8.5,15,162,10.8,3,,creed-whittemore-1
705,J'Wan Evans*,Jacksonville State,CUSA,7,21,60,2.9,4,8.6,2,7,3.5,0,1.0,23,67,2.9,4,,jwan-evans-2
706,Keith Adams Jr.*,Clemson,ACC,7,11,60,5.5,0,8.6,0,0,,0,0.0,11,60,5.5,0,,keith-adams-jr-1
707,Phil Jurkovec,Pitt,ACC,6,39,60,1.5,1,10.0,0,0,,0,0.0,39,60,1.5,1,,phil-jurkovec-1
708,Reggion Bennett*,Jacksonville State,CUSA,10,27,60,2.2,0,6.0,0,0,,0,0.0,27,60,2.2,0,,reggion-bennett-1
709,Ryan Butler,Stanford,Pac-12,10,18,60,3.3,0,6.0,1,4,4.0,0,0.4,19,64,3.4,0,,ryan-butler-1
710,Alton McCaskill,Colorado,Pac-12,4,14,59,4.2,0,14.8,2,19,9.5,0,4.8,16,78,4.9,0,,alton-mccaskill-1
711,Gage Larvadain*,Miami (OH),MAC,10,5,59,11.8,0,5.9,42,679,16.2,6,67.9,47,738,15.7,6,,gage-larvadain-1
712,Sam Jackson*,California,Pac-12,5,26,59,2.3,1,11.8,0,0,,0,0.0,26,59,2.3,1,,sam-jackson-3
713,Cam Cook,TCU,Big 12,9,16,58,3.6,0,6.4,0,0,,0,0.0,16,58,3.6,0,,cam-cook-1
714,Eric Wilson Jr.,Temple,American,6,13,58,4.5,0,9.7,4,10,2.5,0,1.7,17,68,4.0,0,,eric-wilson-jr-1
715,Miles Stewart,Army,Ind,7,15,58,3.9,0,8.3,0,0,,0,0.0,15,58,3.9,0,,miles-stewart-1
716,Jacurri Brown*,Miami (FL),ACC,1,15,57,3.8,2,57.0,0,0,,0,0.0,15,57,3.8,2,,jacurri-brown-1
717,Malik Caper*,Liberty,CUSA,4,13,57,4.4,0,14.3,0,0,,0,0.0,13,57,4.4,0,,malik-caper-1
718,Jarrett Guest*,Coastal Carolina,Sun Belt,6,11,56,5.1,1,9.3,1,-7,-7.0,0,-1.2,12,49,4.1,1,,jarrett-guest-1
719,Jordan McDonald*,UCF,Big 12,11,18,56,3.1,3,5.1,1,33,33.0,0,3.0,19,89,4.7,3,,jordan-mcdonald-1
720,Nick Mosley*,Bowling Green,MAC,4,8,56,7.0,0,14.0,0,0,,0,0.0,8,56,7.0,0,,nick-mosley-1
721,Samuel Singleton Jr.*,Florida State,ACC,2,8,56,7.0,0,28.0,0,0,,0,0.0,8,56,7.0,0,,samuel-singleton-jr-1
722,CJ Harris*,Ohio,MAC,2,12,55,4.6,0,27.5,0,0,,0,0.0,12,55,4.6,0,,cj-harris-2
723,Conner Harrell*,North Carolina,ACC,5,21,55,2.6,1,11.0,0,0,,0,0.0,21,55,2.6,1,,conner-harrell-1
724,Desmond Trotter*,South Alabama,Sun Belt,5,14,55,3.9,1,11.0,0,0,,0,0.0,14,55,3.9,1,,desmond-trotter-1
725,Eugene Wilson III,Florida,SEC,10,6,55,9.2,0,5.5,61,538,8.8,6,53.8,67,593,8.9,6,,eugene-wilson-iii-1
726,Tucker Gleason*,Toledo,MAC,14,12,55,4.6,0,3.9,0,0,,0,0.0,12,55,4.6,0,,tucker-gleason-1
727,Ahmad Haston,Massachusetts,Ind,3,16,54,3.4,0,18.0,0,0,,0,0.0,16,54,3.4,0,,ahmad-haston-1
728,Kaleb Brown*,Iowa,Big Ten,11,9,54,6.0,0,4.9,22,215,9.8,1,19.5,31,269,8.7,1,,kaleb-brown-2
729,Benjamin Yurosek,Stanford,Pac-12,6,11,53,4.8,0,8.8,16,239,14.9,1,39.8,27,292,10.8,1,,benjamin-yurosek-1
730,Ezell Jolly,UTEP,CUSA,4,15,53,3.5,0,13.3,5,32,6.4,0,8.0,20,85,4.3,0,,ezell-jolly-1
731,Jack Shields*,Old Dominion,Sun Belt,6,22,53,2.4,1,8.8,0,0,,0,0.0,22,53,2.4,1,,jack-shields-3
732,Noah Kim,Michigan State,Big Ten,5,27,53,2.0,0,10.6,0,0,,0,0.0,27,53,2.0,0,,noah-kim-1
733,Brock Lampe*,Northern Illinois,MAC,13,13,52,4.0,1,4.0,7,87,12.4,0,6.7,20,139,7.0,1,,brock-lampe-1
734,Lee Witherspoon,UAB,American,12,17,52,3.1,0,4.3,6,37,6.2,0,3.1,23,89,3.9,0,,lee-witherspoon-1
735,Sean Atkins*,South Florida,American,13,6,52,8.7,0,4.0,92,1054,11.5,7,81.1,98,1106,11.3,7,,sean-atkins-1
736,Dalen Cobb*,Georgia Southern,Sun Belt,12,7,51,7.3,0,4.3,40,601,15.0,2,50.1,47,652,13.9,2,,dalen-cobb-1
737,Elijhah Badger,Arizona State,Pac-12,11,11,51,4.6,1,4.6,65,713,11.0,3,64.8,76,764,10.1,4,,elijhah-badger-1
738,Jaylin Lane*,Virginia Tech,ACC,12,14,51,3.6,0,4.3,41,538,13.1,6,44.8,55,589,10.7,6,,jaylin-lane-1
739,Jha'Quan Jackson*,Tulane,American,10,5,51,10.2,0,5.1,26,439,16.9,4,43.9,31,490,15.8,4,,jhaquan-jackson-1
740,LaNorris Sellers,South Carolina,SEC,3,5,51,10.2,1,17.0,0,0,,0,0.0,5,51,10.2,1,,lanorris-sellers-1
741,Marco Lainez*,Iowa,Big Ten,1,6,51,8.5,0,51.0,0,0,,0,0.0,6,51,8.5,0,,marco-lainez-1
742,Owen McCown*,UTSA,American,7,15,51,3.4,0,7.3,0,0,,0,0.0,15,51,3.4,0,,owen-mccown-1
743,Damian Henderson,Colorado State,MWC,2,12,50,4.2,0,25.0,0,0,,0,0.0,12,50,4.2,0,,damian-henderson-1
744,Keyone Jenkins,Florida International,CUSA,11,117,50,0.4,6,4.5,0,0,,1,0.0,117,50,0.4,7,,keyone-jenkins-1
745,Keyvon Walker,Florida Atlantic,American,3,11,50,4.5,0,16.7,0,0,,0,0.0,11,50,4.5,0,,keyvon-walker-1
746,Seth Anderson*,Iowa,Big Ten,14,3,50,16.7,0,3.6,11,150,13.6,1,10.7,14,200,14.3,1,,seth-anderson-1
747,Terrell Washington Jr.*,Iowa,Big Ten,4,9,50,5.6,0,12.5,0,0,,0,0.0,9,50,5.6,0,,terrell-washington-jr-1
748,Evan Pryor*,Ohio State,Big Ten,4,19,49,2.6,0,12.3,1,2,2.0,0,0.5,20,51,2.6,0,,evan-pryor-1
749,Gunnar Gundy*,Oklahoma State,Big 12,4,15,49,3.3,1,12.3,0,0,,0,0.0,15,49,3.3,1,,gunnar-gundy-1
750,Kaedric Cobbs*,UTSA,American,13,12,49,4.1,0,3.8,0,0,,0,0.0,12,49,4.1,0,,kaedric-cobbs-1
751,Ahmari Huggins-Bruce*,Louisville,ACC,14,6,48,8.0,1,3.4,20,312,15.6,4,22.3,26,360,13.8,5,,ahmari-huggins-bruce-1
752,Charlie Vincent*,Utah,Pac-12,11,9,48,5.3,1,4.4,2,11,5.5,0,1.0,11,59,5.4,1,,charlie-vincent-1
753,Grayson McCall*,Coastal Carolina,Sun Belt,7,53,48,0.9,1,6.9,0,0,,0,0.0,53,48,0.9,1,,grayson-mccall-1
754,JC French*,Georgia Southern,Sun Belt,10,14,48,3.4,0,4.8,0,0,,0,0.0,14,48,3.4,0,,jc-french-1
755,Jordan Lovett*,Troy,Sun Belt,4,13,48,3.7,0,12.0,1,-1,-1.0,0,-0.3,14,47,3.4,0,,jordan-lovett-2
756,Kevin Hurley,UTEP,CUSA,7,20,48,2.4,3,6.9,0,0,,0,0.0,20,48,2.4,3,,kevin-hurley-1
757,Ty Thompson*,Oregon,Pac-12,7,8,48,6.0,0,6.9,0,0,,0,0.0,8,48,6.0,0,,ty-thompson-2
758,DJ Oliver*,West Virginia,Big 12,5,12,47,3.9,1,9.4,0,0,,0,0.0,12,47,3.9,1,,dj-oliver-1
759,Evan Dickens*,Georgia Tech,ACC,12,11,47,4.3,0,3.9,1,5,5.0,0,0.4,12,52,4.3,0,,evan-dickens-1
760,Hank Bachmeier,Louisiana Tech,CUSA,9,58,47,0.8,2,5.2,0,0,,0,0.0,58,47,0.8,2,,hank-bachmeier-1
761,Sam Hicks,Central Michigan,MAC,12,11,47,4.3,1,3.9,4,12,3.0,0,1.0,15,59,3.9,1,,sam-hicks-1
762,Thaddius Franklin Jr.,Louisiana-Monroe,Sun Belt,5,12,47,3.9,1,9.4,0,0,,0,0.0,12,47,3.9,1,,thaddius-franklin-jr-1
763,Brandon Campbell,Houston,Big 12,5,18,46,2.6,0,9.2,1,3,3.0,0,0.6,19,49,2.6,0,,brandon-campbell-4
764,Jacob De Jesus*,Nevada-Las Vegas,MWC,14,11,46,4.2,1,3.3,60,606,10.1,2,43.3,71,652,9.2,3,,jacob-de-jesus-1
765,Ja'khi Douglas*,Florida State,ACC,10,8,46,5.8,0,4.6,14,243,17.4,0,24.3,22,289,13.1,0,,jakhi-douglas-1
766,Bryson Washington,Baylor,Big 12,3,10,45,4.5,0,15.0,1,1,1.0,0,0.3,11,46,4.2,0,,bryson-washington-3
767,Cooper Jones*,Utah State,MWC,4,14,45,3.2,1,11.3,0,0,,0,0.0,14,45,3.2,1,,cooper-jones-2
768,Marcel Reed*,Texas A&M,SEC,3,13,45,3.5,1,15.0,0,0,,0,0.0,13,45,3.5,1,,marcel-reed-1
769,Money Parks*,Utah,Pac-12,13,7,45,6.4,0,3.5,31,293,9.5,2,22.5,38,338,8.9,2,,money-parks-1
770,Spencer Sanders*,Ole Miss,SEC,9,11,45,4.1,0,5.0,0,0,,0,0.0,11,45,4.1,0,,spencer-sanders-1
771,Xavier Terrell,Florida Atlantic,American,2,5,45,9.0,0,22.5,2,10,5.0,0,5.0,7,55,7.9,0,,xavier-terrell-1
772,Devon Rivers*,Fresno State,MWC,3,12,44,3.7,0,14.7,0,0,,0,0.0,12,44,3.7,0,,devon-rivers-1
773,Devyn Ford*,Notre Dame,Ind,11,8,44,5.5,0,4.0,4,34,8.5,1,3.1,12,78,6.5,1,,devyn-ford-1
774,Jacolby Criswell,Arkansas,SEC,4,23,44,1.9,0,11.0,0,0,,0,0.0,23,44,1.9,0,,jacolby-criswell-1
775,Jaylen Poe*,Northern Illinois,MAC,1,6,44,7.3,0,44.0,0,0,,0,0.0,6,44,7.3,0,,jaylen-poe-1
776,LaJohntay Wester,Florida Atlantic,American,12,8,44,5.5,1,3.7,108,1168,10.8,8,97.3,116,1212,10.4,9,,lajohntay-wester-1
777,Caleb Hood*,North Carolina,ACC,7,15,43,2.9,1,6.1,1,9,9.0,0,1.3,16,52,3.3,1,,caleb-hood-1
778,David Amador II*,UTSA,American,13,2,43,21.5,0,3.3,11,102,9.3,1,7.8,13,145,11.2,1,,david-amador-ii-1
779,Germie Bernard*,Washington,Pac-12,14,13,43,3.3,2,3.1,34,419,12.3,2,29.9,47,462,9.8,4,,germie-bernard-1
780,Ke'Travion Hargrove*,Memphis,American,12,11,43,3.9,1,3.6,0,0,,0,0.0,11,43,3.9,1,,ketravion-hargrove-1
781,Anthony Frias II*,Kansas State,Big 12,10,13,42,3.2,0,4.2,2,5,2.5,0,0.5,15,47,3.1,0,,anthony-frias-ii-1
782,Dalen Morris,Hawaii,MWC,9,16,42,2.6,2,4.7,0,0,,0,0.0,16,42,2.6,2,,dalen-morris-2
783,Daylan Smothers*,Oklahoma,Big 12,4,11,42,3.8,0,10.5,1,1,1.0,0,0.3,12,43,3.6,0,,daylan-smothers-1
784,Evan Conley*,Louisville,ACC,14,7,42,6.0,2,3.0,0,0,,0,0.0,7,42,6.0,2,,evan-conley-1
785,Travis Bates*,Duke,ACC,13,5,42,8.4,0,3.2,0,0,,0,0.0,5,42,8.4,0,,travis-bates-1
786,Brennan Presley*,Oklahoma State,Big 12,14,11,41,3.7,2,2.9,101,991,9.8,6,70.8,112,1032,9.2,8,,brennan-presley-1
787,Harold Fannin Jr.*,Bowling Green,MAC,11,14,41,2.9,0,3.7,44,623,14.2,6,56.6,58,664,11.4,6,,harold-fannin-jr-1
788,Jevyon Ducker*,Memphis,American,5,8,41,5.1,0,8.2,3,16,5.3,0,3.2,11,57,5.2,0,,jevyon-ducker-1
789,Simeon Price,Mississippi State,SEC,9,5,41,8.2,0,4.6,2,13,6.5,0,1.4,7,54,7.7,0,,simeon-price-1
790,Tariq Sims*,Old Dominion,Sun Belt,7,15,41,2.7,0,5.9,1,1,1.0,0,0.1,16,42,2.6,0,,tariq-sims-1
791,Trsiten Rigby*,Clemson,ACC,2,2,41,20.5,0,20.5,0,0,,0,0.0,2,41,20.5,0,,trsiten-rigby-1
792,Tyler Brown*,Clemson,ACC,13,2,41,20.5,0,3.2,52,531,10.2,4,40.8,54,572,10.6,4,,tyler-brown-7
793,Amare Thomas,UAB,American,12,4,40,10.0,0,3.3,53,437,8.2,3,36.4,57,477,8.4,3,,amare-thomas-1
794,Cornelius Johnson*,Michigan,Big Ten,15,3,40,13.3,0,2.7,47,604,12.9,1,40.3,50,644,12.9,1,,cornelius-johnson-1
795,Geordon Porter,Connecticut,Ind,12,5,40,8.0,0,3.3,22,213,9.7,1,17.8,27,253,9.4,1,,geordon-porter-1
796,Kaden Dudley*,Boise State,MWC,10,8,40,5.0,0,4.0,4,12,3.0,0,1.2,12,52,4.3,0,,kaden-dudley-1
797,Keelan Marion,BYU,Big 12,12,9,40,4.4,3,3.3,20,216,10.8,0,18.0,29,256,8.8,3,,keelan-marion-1
798,Logan Fife*,Fresno State,MWC,12,28,40,1.4,1,3.3,0,0,,0,0.0,28,40,1.4,1,,logan-fife-1
799,Nolan McCormick*,Ohio,MAC,1,11,40,3.6,0,40.0,0,0,,0,0.0,11,40,3.6,0,,nolan-mccormick-1
800,Perry Carter*,Jacksonville State,CUSA,13,6,40,6.7,0,3.1,38,672,17.7,4,51.7,44,712,16.2,4,,perry-carter-2
801,Ryan O'Keefe*,Boston College,ACC,5,5,40,8.0,1,8.0,23,235,10.2,1,47.0,28,275,9.8,2,,ryan-okeefe-1
802,Torry Locklin*,Kansas,Big 12,13,9,40,4.4,0,3.1,4,40,10.0,1,3.1,13,80,6.2,1,,torry-locklin-1
803,William Watson III*,Virginia Tech,ACC,2,5,40,8.0,0,20.0,0,0,,0,0.0,5,40,8.0,0,,william-watson-iii-1
804,BJ Harris,Central Michigan,MAC,10,19,39,2.1,0,3.9,1,9,9.0,0,0.9,20,48,2.4,0,,bj-harris-1
805,Brian Snead*,Arkansas State,Sun Belt,4,16,39,2.4,0,9.8,1,7,7.0,0,1.8,17,46,2.7,0,,brian-snead-2
806,Brock Vandagriff*,Georgia,SEC,8,5,39,7.8,0,4.9,0,0,,0,0.0,5,39,7.8,0,,brock-vandagriff-1
807,Curtis Douglas,Kent State,MAC,3,8,39,4.9,0,13.0,0,0,,0,0.0,8,39,4.9,0,,curtis-douglas-1
808,Jamious Griffin*,Ole Miss,SEC,12,7,39,5.6,0,3.3,0,0,,0,0.0,7,39,5.6,0,,jamious-griffin-1
809,Leroy Thomas,Western Michigan,MAC,12,7,39,5.6,0,3.3,35,389,11.1,2,32.4,42,428,10.2,2,,leroy-thomas-3
810,TJ Jones,UAB,American,12,4,39,9.8,0,3.3,15,222,14.8,2,18.5,19,261,13.7,2,,tj-jones-7
811,Derrick Edwards*,Louisville,ACC,11,5,38,7.6,0,3.5,0,0,,0,0.0,5,38,7.6,0,,derrick-edwards-1
812,Isaiah Williams,Illinois,Big Ten,12,12,38,3.2,0,3.2,82,1055,12.9,5,87.9,94,1093,11.6,5,,isaiah-williams-7
813,Jack Salopek,Western Michigan,MAC,6,18,38,2.1,0,6.3,0,0,,0,0.0,18,38,2.1,0,,jack-salopek-1
814,Junior Vandeross III*,Toledo,MAC,14,3,38,12.7,0,2.7,47,664,14.1,4,47.4,50,702,14.0,4,,junior-vandeross-iii-1
815,Ladd McConkey*,Georgia,SEC,9,2,38,19.0,1,4.2,30,478,15.9,2,53.1,32,516,16.1,3,,ladd-mcconkey-1
816,Taisun Phommachanh,Massachusetts,Ind,9,48,38,0.8,2,4.2,0,0,,0,0.0,48,38,0.8,2,,taisun-phommachanh-1
817,Trace Campbell,UAB,American,1,6,38,6.3,0,38.0,0,0,,0,0.0,6,38,6.3,0,,trace-campbell-2
818,Andre Hines*,Boston College,ACC,2,6,37,6.2,0,18.5,0,0,,0,0.0,6,37,6.2,0,,andre-hines-1
819,Ari Patu,Stanford,Pac-12,2,4,37,9.3,0,18.5,0,0,,0,0.0,4,37,9.3,0,,ari-patu-1
820,Max Brown,Florida,SEC,6,23,37,1.6,0,6.2,0,0,,0,0.0,23,37,1.6,0,,max-brown-1
821,Rome Odunze*,Washington,Pac-12,15,2,37,18.5,1,2.5,92,1640,17.8,13,109.3,94,1677,17.8,14,AA,rome-odunze-1
822,Tyler Crowe*,Boise State,MWC,10,10,37,3.7,0,3.7,3,21,7.0,0,2.1,13,58,4.5,0,,tyler-crowe-1
823,Blaze Berlowitz*,New Mexico State,CUSA,1,4,36,9.0,0,36.0,0,0,,0,0.0,4,36,9.0,0,,blaze-berlowitz-1
824,Jadon Jackson*,Kansas State,Big 12,13,4,36,9.0,0,2.8,19,252,13.3,2,19.4,23,288,12.5,2,,jadon-jackson-1
825,Kaden Prather*,Maryland,Big Ten,13,1,36,36.0,0,2.8,42,666,15.9,5,51.2,43,702,16.3,5,,kaden-prather-1
826,McCae Hillstead*,Utah State,MWC,8,44,36,0.8,0,4.5,0,0,,0,0.0,44,36,0.8,0,,mccae-hillstead-1
827,Sevaughn Clark*,Georgia,SEC,6,8,36,4.5,1,6.0,0,0,,0,0.0,8,36,4.5,1,,sevaughn-clark-1
828,Christian Nash*,Northern Illinois,MAC,2,8,35,4.4,0,17.5,0,0,,0,0.0,8,35,4.4,0,,christian-nash-2
829,Daelen Alexander*,Rice,American,6,18,35,1.9,5,5.8,1,3,3.0,1,0.5,19,38,2.0,6,,daelen-alexander-1
830,Jack Tuttle*,Michigan,Big Ten,6,4,35,8.8,0,5.8,0,0,,0,0.0,4,35,8.8,0,,jack-tuttle-1
831,Jay Haynes*,Clemson,ACC,3,6,35,5.8,1,11.7,2,20,10.0,1,6.7,8,55,6.9,2,,jay-haynes-1
832,Jonathan Brady*,New Mexico State,CUSA,15,9,35,3.9,1,2.3,39,621,15.9,4,41.4,48,656,13.7,5,,jonathan-brady-1
833,Tobias Weaver,Sam Houston,CUSA,4,17,35,2.1,0,8.8,1,4,4.0,0,1.0,18,39,2.2,0,,tobias-weaver-1
834,Xavier Worthy*,Texas,Big 12,14,4,35,8.8,0,2.5,75,1014,13.5,5,72.4,79,1049,13.3,5,,xavier-worthy-1
835,Cole Kramer*,Minnesota,Big Ten,3,5,34,6.8,1,11.3,0,0,,0,0.0,5,34,6.8,1,,cole-kramer-1
836,Cross Patton,Nevada,MWC,5,13,34,2.6,0,6.8,3,0,0.0,0,0.0,16,34,2.1,0,,cross-patton-1
837,Doug Brumfield*,Nevada-Las Vegas,MWC,8,24,34,1.4,1,4.3,0,0,,0,0.0,24,34,1.4,1,,doug-brumfield-1
838,Hunter Clark,Connecticut,Ind,10,3,34,11.3,0,3.4,0,0,,0,0.0,3,34,11.3,0,,hunter-clark-1
839,Ikaika Ragsdale,North Texas,American,2,9,34,3.8,0,17.0,0,0,,0,0.0,9,34,3.8,0,,ikaika-ragsdale-1
840,Jack Griese,Virginia,ACC,10,11,34,3.1,1,3.4,3,25,8.3,0,2.5,14,59,4.2,1,,jack-griese-1
841,Jack Plummer*,Louisville,ACC,14,98,34,0.3,1,2.4,0,0,,0,0.0,98,34,0.3,1,,jack-plummer-1
842,Jake Reichle*,Oregon State,Pac-12,13,4,34,8.5,0,2.6,1,1,1.0,0,0.1,5,35,7.0,0,,jake-reichle-1
843,Mike Sharpe II*,Arkansas State,Sun Belt,8,9,34,3.8,0,4.3,0,0,,0,0.0,9,34,3.8,0,,mike-sharpe-ii-1
844,Tyler Walton*,Ohio,MAC,12,5,34,6.8,0,2.8,37,349,9.4,2,29.1,42,383,9.1,2,,tyler-walton-1
845,Antonio Patterson,Florida International,CUSA,9,14,33,2.4,1,3.7,1,0,0.0,0,0.0,15,33,2.2,1,,antonio-patterson-1
846,Arian Smith*,Georgia,SEC,14,1,33,33.0,0,2.4,8,153,19.1,2,10.9,9,186,20.7,2,,arian-smith-1
847,Jahbari Kuykendall*,Coastal Carolina,Sun Belt,1,3,33,11.0,0,33.0,0,0,,0,0.0,3,33,11.0,0,,jahbari-kuykendall-1
848,Jordan Nabors,Baylor,Big 12,9,9,33,3.7,0,3.7,8,73,9.1,0,8.1,17,106,6.2,0,,jordan-nabors-1
849,Justin Jones*,Auburn,SEC,13,4,33,8.3,0,2.5,0,0,,0,0.0,4,33,8.3,0,,justin-jones-6
850,Leon Franklin*,Michigan,Big Ten,14,11,33,3.0,1,2.4,1,6,6.0,0,0.4,12,39,3.3,1,,leon-franklin-1
851,Mac Dalena*,Fresno State,MWC,13,1,33,33.0,0,2.5,47,509,10.8,3,39.2,48,542,11.3,3,,mac-dalena-1
852,Mark-Antony Richards*,UCF,Big 12,13,8,33,4.1,1,2.5,3,18,6.0,0,1.4,11,51,4.6,1,,mark-antony-richards-1
853,Patrick Wilk*,Tennessee,SEC,1,2,33,16.5,0,33.0,0,0,,0,0.0,2,33,16.5,0,,patrick-wilk-1
854,Phillip Brooks*,Kansas State,Big 12,12,7,33,4.7,1,2.8,53,589,11.1,5,49.1,60,622,10.4,6,,phillip-brooks-1
855,Tucker Holloway*,Virginia Tech,ACC,13,1,33,33.0,1,2.5,5,49,9.8,0,3.8,6,82,13.7,1,,tucker-holloway-1
856,Dontae McMillan*,Eastern Michigan,MAC,8,11,32,2.9,1,4.0,1,12,12.0,0,1.5,12,44,3.7,1,,dontae-mcmillan-1
857,Dorian Smith*,South Alabama,Sun Belt,5,3,32,10.7,1,6.4,1,3,3.0,0,0.6,4,35,8.8,1,,dorian-smith-2
858,Jakarius Caston,Southern Mississippi,Sun Belt,12,4,32,8.0,1,2.7,33,621,18.8,6,51.8,37,653,17.6,7,,jakarius-caston-1
859,Jake McNamara,UTEP,CUSA,2,8,32,4.0,1,16.0,0,0,,0,0.0,8,32,4.0,1,,jake-mcnamara-1
860,Ja'lynn Polk*,Washington,Pac-12,15,4,32,8.0,1,2.1,69,1159,16.8,9,77.3,73,1191,16.3,10,,jalynn-polk-1
861,J.J. Kohl*,Iowa State,Big 12,3,6,32,5.3,0,10.7,0,0,,0,0.0,6,32,5.3,0,,jj-kohl-1
862,Joe Fagnano,Connecticut,Ind,2,16,32,2.0,0,16.0,0,0,,0,0.0,16,32,2.0,0,,joe-fagnano-1
863,Miller Moss*,USC,Pac-12,5,4,32,8.0,2,6.4,0,0,,0,0.0,4,32,8.0,2,,miller-moss-1
864,Ashton Frye*,Jacksonville State,CUSA,5,10,31,3.1,0,6.2,0,0,,0,0.0,10,31,3.1,0,,ashton-frye-1
865,Ben Brittain*,Air Force,MWC,4,7,31,4.4,0,7.8,0,0,,0,0.0,7,31,4.4,0,,ben-brittain-1
866,Demetrius Battle,UAB,American,9,8,31,3.9,1,3.4,0,0,,0,0.0,8,31,3.9,1,,demetrius-battle-1
867,Jalen John,Massachusetts,Ind,8,10,31,3.1,0,3.9,0,0,,0,0.0,10,31,3.1,0,,jalen-john-6
868,Jeremy Hollingsworth*,Wyoming,MWC,4,6,31,5.2,0,7.8,0,0,,0,0.0,6,31,5.2,0,,jeremy-hollingsworth-1
869,Keyon Lesane*,North Carolina State,ACC,13,4,31,7.8,0,2.4,28,247,8.8,0,19.0,32,278,8.7,0,,keyon-lesane-1
870,Luther Burden*,Missouri,SEC,13,7,31,4.4,0,2.4,86,1212,14.1,9,93.2,93,1243,13.4,9,,luther-burden-1
871,Ui Ale,Houston,Big 12,3,8,31,3.9,0,10.3,0,0,,0,0.0,8,31,3.9,0,,ui-ale-1
872,Braylen Walker*,Rice,American,12,3,30,10.0,0,2.5,13,200,15.4,2,16.7,16,230,14.4,2,,braylen-walker-1
873,Connor Walendzak*,Toledo,MAC,13,17,30,1.8,2,2.3,2,22,11.0,0,1.7,19,52,2.7,2,,connor-walendzak-1
874,Dominique Shoffner,Charlotte,American,3,7,30,4.3,0,10.0,0,0,,0,0.0,7,30,4.3,0,,dominique-shoffner-1
875,Jabari Bates*,San Jose State,MWC,13,11,30,2.7,0,2.3,9,32,3.6,0,2.5,20,62,3.1,0,,jabari-bates-1
876,Jack Blumer*,Kansas State,Big 12,13,1,30,30.0,0,2.3,0,0,,0,0.0,1,30,30.0,0,,jack-blumer-1
877,Jalen McMillan*,Washington,Pac-12,11,3,30,10.0,1,2.7,45,559,12.4,5,50.8,48,589,12.3,6,,jalen-mcmillan-1
878,Justin Holmes,Kent State,MAC,12,1,30,30.0,0,2.5,20,188,9.4,0,15.7,21,218,10.4,0,,justin-holmes-3
879,Ken Seals,Vanderbilt,SEC,10,40,30,0.8,2,3.0,0,0,,0,0.0,40,30,0.8,2,,ken-seals-1
880,Mario Escobar*,Syracuse,ACC,4,4,30,7.5,0,7.5,0,0,,0,0.0,4,30,7.5,0,,mario-escobar-1
881,Richard Newton*,Washington,Pac-12,13,5,30,6.0,0,2.3,0,0,,0,0.0,5,30,6.0,0,,richard-newton-1
882,Thomas Pannunzio,Central Michigan,MAC,12,3,30,10.0,0,2.5,12,99,8.3,1,8.3,15,129,8.6,1,,thomas-pannunzio-1
883,Victor Snow,Buffalo,MAC,10,5,30,6.0,0,3.0,1,12,12.0,0,1.2,6,42,7.0,0,,victor-snow-1
884,Alonza Barnett III*,James Madison,Sun Belt,2,5,29,5.8,1,14.5,0,0,,0,0.0,5,29,5.8,1,,alonza-barnett-iii-1
885,Amaad Foston,Virginia,ACC,4,5,29,5.8,0,7.3,1,1,1.0,0,0.3,6,30,5.0,0,,amaad-foston-1
886,Blake Shapen,Baylor,Big 12,8,67,29,0.4,4,3.6,1,-6,-6.0,0,-0.8,68,23,0.3,4,,blake-shapen-1
887,Jaxon Dailey*,Arkansas State,Sun Belt,5,11,29,2.6,0,5.8,0,0,,0,0.0,11,29,2.6,0,,jaxon-dailey-1
888,Junior Sherrill,Vanderbilt,SEC,12,4,29,7.3,0,2.4,20,293,14.7,3,24.4,24,322,13.4,3,,junior-sherrill-1
889,Ke'Shawn Williams,Wake Forest,ACC,11,3,29,9.7,1,2.6,38,384,10.1,1,34.9,41,413,10.1,2,,keshawn-williams-2
890,Nate Johnson*,Boston College,ACC,8,5,29,5.8,0,3.6,1,11,11.0,0,1.4,6,40,6.7,0,,nate-johnson-4
891,Omarion Dollison*,James Madison,Sun Belt,11,2,29,14.5,0,2.6,1,54,54.0,1,4.9,3,83,27.7,1,,omarion-dollison-1
892,Tiger Bachmeier,Stanford,Pac-12,12,2,29,14.5,1,2.4,36,409,11.4,2,34.1,38,438,11.5,3,,tiger-bachmeier-1
893,Trevin Luben,Nebraska,Big Ten,6,3,29,9.7,0,4.8,0,0,,0,0.0,3,29,9.7,0,,trevin-luben-1
894,Zach Pyron*,Georgia Tech,ACC,6,8,29,3.6,0,4.8,0,0,,0,0.0,8,29,3.6,0,,zach-pyron-1
895,Al-Shadee Salaam*,Rutgers,Big Ten,13,6,28,4.7,1,2.2,0,0,,0,0.0,6,28,4.7,1,,al-shadee-salaam-1
896,Amir Hassan,Navy,American,12,12,28,2.3,0,2.3,3,11,3.7,0,0.9,15,39,2.6,0,,amir-hassan-1
897,Antavious Willis,Southern Mississippi,Sun Belt,12,6,28,4.7,0,2.3,3,41,13.7,0,3.4,9,69,7.7,0,,antavious-willis-1
898,Brock Bowers*,Georgia,SEC,10,6,28,4.7,1,2.8,56,714,12.8,6,71.4,62,742,12.0,7,AA,brock-bowers-1
899,Chris Curry*,Utah,Pac-12,3,8,28,3.5,0,9.3,0,0,,0,0.0,8,28,3.5,0,,chris-curry-2
900,Henry Belvin IV*,Duke,ACC,4,8,28,3.5,1,7.0,0,0,,0,0.0,8,28,3.5,1,,henry-belvin-iv-1
901,Isaiah Sategna,Arkansas,SEC,12,1,28,28.0,0,2.3,15,129,8.6,2,10.8,16,157,9.8,2,,isaiah-sategna-1
902,Jeremiah Coney*,Virginia Tech,ACC,4,10,28,2.8,0,7.0,1,2,2.0,0,0.5,11,30,2.7,0,,jeremiah-coney-1
903,Lucian Anderson III*,Bowling Green,MAC,3,8,28,3.5,1,9.3,0,0,,0,0.0,8,28,3.5,1,,lucian-anderson-iii-1
904,Mike Drennen*,Toledo,MAC,1,7,28,4.0,1,28.0,2,16,8.0,0,16.0,9,44,4.9,1,,mike-drennen-1
905,Tiaquelin Mims,Southern Mississippi,Sun Belt,12,5,28,5.6,0,2.3,39,445,11.4,2,37.1,44,473,10.8,2,,tiaquelin-mims-1
906,Alex Smith*,Georgia Southern,Sun Belt,13,2,27,13.5,0,2.1,0,0,,0,0.0,2,27,13.5,0,,alex-smith-12
907,Chamon Metayer,Cincinnati,Big 12,11,1,27,27.0,0,2.5,23,258,11.2,5,23.5,24,285,11.9,5,,chamon-metayer-1
908,Corey Wren,TCU,Big 12,12,9,27,3.0,0,2.3,1,5,5.0,0,0.4,10,32,3.2,0,,corey-wren-1
909,Max Johnson*,Texas A&M,SEC,8,51,27,0.5,2,3.4,0,0,,0,0.0,51,27,0.5,2,,max-johnson-2
910,Sesi Vailahi*,Oklahoma State,Big 12,3,6,27,4.5,0,9.0,2,12,6.0,0,4.0,8,39,4.9,0,,sesi-vailahi-1
911,Steve Angeli*,Notre Dame,Ind,8,8,27,3.4,0,3.4,0,0,,0,0.0,8,27,3.4,0,,steve-angeli-1
912,Chandler Pittman,Southern Mississippi,Sun Belt,12,9,26,2.9,0,2.2,16,130,8.1,0,10.8,25,156,6.2,0,,chandler-pittman-1
913,Devin Boddie Jr.*,Wyoming,MWC,13,4,26,6.5,0,2.0,6,48,8.0,0,3.7,10,74,7.4,0,,devin-boddie-jr-1
914,Jacob Cowing*,Arizona,Pac-12,13,5,26,5.2,0,2.0,90,848,9.4,13,65.2,95,874,9.2,13,,jacob-cowing-1
915,Keagan Johnson*,Kansas State,Big 12,11,8,26,3.3,0,2.4,24,227,9.5,2,20.6,32,253,7.9,2,,keagan-johnson-1
916,Major Everhart,TCU,Big 12,12,7,26,3.7,0,2.2,20,197,9.9,0,16.4,27,223,8.3,0,,major-everhart-1
917,Marvin Harrison Jr.*,Ohio State,Big Ten,12,2,26,13.0,1,2.2,67,1211,18.1,14,100.9,69,1237,17.9,15,H-4AA,marvin-harrison-jr-1
918,Anton Hall,Navy,American,12,8,25,3.1,2,2.1,3,52,17.3,1,4.3,11,77,7.0,3,,anton-hall-1
919,Dalvin Smith*,Western Kentucky,CUSA,11,1,25,25.0,0,2.3,50,513,10.3,6,46.6,51,538,10.5,6,,dalvin-smith-1
920,Dayton Wade*,Ole Miss,SEC,13,7,25,3.6,0,1.9,55,830,15.1,4,63.8,62,855,13.8,4,,dayton-wade-1
921,Djay Braswell,South Carolina,SEC,6,12,25,2.1,0,4.2,3,35,11.7,0,5.8,15,60,4.0,0,,djay-braswell-1
922,Emeka Egbuka*,Ohio State,Big Ten,10,5,25,5.0,0,2.5,41,515,12.6,4,51.5,46,540,11.7,4,,emeka-egbuka-1
923,Kevin Coleman Jr.*,Louisville,ACC,14,6,25,4.2,0,1.8,26,362,13.9,2,25.9,32,387,12.1,2,,kevin-coleman-jr-1
924,Landon Sides,North Texas,American,11,4,25,6.3,0,2.3,30,363,12.1,4,33.0,34,388,11.4,4,,landon-sides-1
925,Lawrence Keys III*,Tulane,American,10,4,25,6.3,0,2.5,33,599,18.2,7,59.9,37,624,16.9,7,,lawrence-keys-iii-1
926,Logan Kyle,Vanderbilt,SEC,12,2,25,12.5,0,2.1,11,103,9.4,0,8.6,13,128,9.8,0,,logan-kyle-1
927,Malcolm Gillie,Ball State,MAC,10,4,25,6.3,0,2.5,9,81,9.0,0,8.1,13,106,8.2,0,,malcolm-gillie-1
928,Quinton Jackson*,Rice,American,13,7,25,3.6,0,1.9,6,33,5.5,0,2.5,13,58,4.5,0,,quinton-jackson-1
929,Trent Battle,TCU,Big 12,12,10,25,2.5,0,2.1,4,68,17.0,0,5.7,14,93,6.6,0,,trent-battle-1
930,Victor Venn*,Liberty,CUSA,10,5,25,5.0,0,2.5,2,10,5.0,1,1.0,7,35,5.0,1,,victor-venn-1
931,Alan Bowman*,Oklahoma State,Big 12,14,26,24,0.9,2,1.7,1,3,3.0,0,0.2,27,27,1.0,2,,alan-bowman-1
932,Colton Boomer*,UCF,Big 12,13,1,24,24.0,0,1.8,0,0,,0,0.0,1,24,24.0,0,,colton-boomer-1
933,Earl Woods III*,Jacksonville State,CUSA,3,4,24,6.0,0,8.0,0,0,,0,0.0,4,24,6.0,0,,earl-woods-iii-1
934,Fraser Masin*,Ole Miss,SEC,13,1,24,24.0,0,1.8,0,0,,0,0.0,1,24,24.0,0,,fraser-masin-1
935,Jaelen Gill*,Fresno State,MWC,13,10,24,2.4,0,1.8,49,516,10.5,6,39.7,59,540,9.2,6,,jaelen-gill-1
936,Jordan Branch,Middle Tennessee State,CUSA,12,1,24,24.0,0,2.0,0,0,,0,0.0,1,24,24.0,0,,jordan-branch-1
937,Khalifa Keith*,Tennessee,SEC,12,11,24,2.2,0,2.0,0,0,,0,0.0,11,24,2.2,0,,khalifa-keith-1
938,Landon Robinson,Navy,American,12,1,24,24.0,0,2.0,0,0,,0,0.0,1,24,24.0,0,,landon-robinson-1
939,Richard Young*,Alabama,SEC,3,9,24,2.7,1,8.0,0,0,,0,0.0,9,24,2.7,1,,richard-young-2
940,Ron Tiavaasue*,New Mexico State,CUSA,15,2,24,12.0,1,1.6,3,44,14.7,1,2.9,5,68,13.6,2,,ron-tiavaasue-2
941,Bugs Mortimer,Louisiana-Monroe,Sun Belt,9,3,23,7.7,0,2.6,15,291,19.4,0,32.3,18,314,17.4,0,,bugs-mortimer-1
942,Daniyel Ngata*,Washington,Pac-12,10,7,23,3.3,1,2.3,0,0,,0,0.0,7,23,3.3,1,,daniyel-ngata-1
943,David Egbe,Wake Forest,ACC,8,9,23,2.6,0,2.9,0,0,,0,0.0,9,23,2.6,0,,david-egbe-1
944,Devin Brown*,Ohio State,Big Ten,6,22,23,1.0,1,3.8,0,0,,0,0.0,22,23,1.0,1,,devin-brown-2
945,Devontez Walker*,North Carolina,ACC,8,3,23,7.7,0,2.9,41,699,17.0,7,87.4,44,722,16.4,7,,devontez-walker-1
946,Jaden Rashada,Arizona State,Pac-12,3,14,23,1.6,0,7.7,0,0,,0,0.0,14,23,1.6,0,,jaden-rashada-1
947,Kameron Ingram*,UCF,Big 12,1,4,23,5.8,0,23.0,1,15,15.0,0,15.0,5,38,7.6,0,,kameron-ingram-1
948,Kendrell Williams*,Louisiana,Sun Belt,2,3,23,7.7,0,11.5,0,0,,0,0.0,3,23,7.7,0,,kendrell-williams-1
949,Khaleb Hood*,Georgia Southern,Sun Belt,13,3,23,7.7,0,1.8,101,948,9.4,5,72.9,104,971,9.3,5,,khaleb-hood-1
950,Kylen Austin*,Liberty,CUSA,13,3,23,7.7,0,1.8,3,84,28.0,0,6.5,6,107,17.8,0,,kylen-austin-1
951,Roderick Daniels Jr.*,SMU,American,14,15,23,1.5,0,1.6,24,370,15.4,4,26.4,39,393,10.1,4,,roderick-daniels-jr-1
952,Sam Adams II*,Washington,Pac-12,10,10,23,2.3,1,2.3,2,16,8.0,0,1.6,12,39,3.3,1,,sam-adams-ii-1
953,Sterling Galban*,Jacksonville State,CUSA,13,6,23,3.8,0,1.8,11,126,11.5,1,9.7,17,149,8.8,1,,sterling-galban-1
954,Terrance Gibbs*,Georgia Southern,Sun Belt,7,9,23,2.6,0,3.3,0,0,,0,0.0,9,23,2.6,0,,terrance-gibbs-1
955,Tevin White,Arizona State,Pac-12,11,11,23,2.1,0,2.1,1,4,4.0,0,0.4,12,27,2.3,0,,tevin-white-1
956,Wayne Knight*,James Madison,Sun Belt,4,4,23,5.8,0,5.8,1,11,11.0,0,2.8,5,34,6.8,0,,wayne-knight-1
957,Zavion Thomas,Mississippi State,SEC,11,12,23,1.9,0,2.1,40,503,12.6,1,45.7,52,526,10.1,1,,zavion-thomas-1
958,Anthony Gould*,Oregon State,Pac-12,11,4,22,5.5,0,2.0,44,718,16.3,2,65.3,48,740,15.4,2,,anthony-gould-1
959,Brock Glenn*,Florida State,ACC,5,19,22,1.2,1,4.4,0,0,,0,0.0,19,22,1.2,1,,brock-glenn-1
960,Chance Black*,Virginia Tech,ACC,10,6,22,3.7,0,2.2,0,0,,0,0.0,6,22,3.7,0,,chance-black-2
961,Che Nwabuko,Pitt,ACC,12,3,22,7.3,0,1.8,0,0,,0,0.0,3,22,7.3,0,,che-nwabuko-1
962,Chrishon McCray,Kent State,MAC,9,4,22,5.5,0,2.4,41,610,14.9,4,67.8,45,632,14.0,4,,chrishon-mccray-1
963,Dante Jackson,Akron,MAC,12,1,22,22.0,0,1.8,0,0,,0,0.0,1,22,22.0,0,,dante-jackson-2
964,Jelani Stafford,Connecticut,Ind,12,15,22,1.5,6,1.8,1,10,10.0,0,0.8,16,32,2.0,6,,jelani-stafford-1
965,Jordan Faison*,Notre Dame,Ind,7,2,22,11.0,0,3.1,19,322,16.9,4,46.0,21,344,16.4,4,,jordan-faison-1
966,K.D. Hutchinson*,Western Kentucky,CUSA,13,3,22,7.3,1,1.7,20,194,9.7,2,14.9,23,216,9.4,3,,kd-hutchinson-1
967,Quintell Quinn*,Ohio,MAC,7,5,22,4.4,0,3.1,0,0,,0,0.0,5,22,4.4,0,,quintell-quinn-1
968,RJ Martinez,Baylor,Big 12,3,3,22,7.3,0,7.3,0,0,,0,0.0,3,22,7.3,0,,rj-martinez-1
969,Wyatt Wieland*,Wyoming,MWC,13,7,22,3.1,1,1.7,44,480,10.9,5,36.9,51,502,9.8,6,,wyatt-wieland-1
970,Ainias Smith*,Texas A&M,SEC,12,5,21,4.2,0,1.8,53,795,15.0,2,66.3,58,816,14.1,2,,ainias-smith-1
971,Caleb McMillan*,Marshall,Sun Belt,11,1,21,21.0,1,1.9,18,275,15.3,2,25.0,19,296,15.6,3,,caleb-mcmillan-1
972,Dane Kinamon*,Air Force,MWC,8,7,21,3.0,0,2.6,5,126,25.2,2,15.8,12,147,12.3,2,,dane-kinamon-1
973,Daryon Triche,UTEP,CUSA,2,5,21,4.2,0,10.5,2,11,5.5,0,5.5,7,32,4.6,0,,daryon-triche-1
974,Garret Rangel*,Oklahoma State,Big 12,5,6,21,3.5,0,4.2,0,0,,0,0.0,6,21,3.5,0,,garret-rangel-1
975,Grayson James,Florida International,CUSA,3,21,21,1.0,1,7.0,0,0,,0,0.0,21,21,1.0,1,,grayson-james-1
976,Jack Dawson*,Jacksonville State,CUSA,13,2,21,10.5,0,1.6,0,0,,0,0.0,2,21,10.5,0,,jack-dawson-2
977,Lincoln Victor,Washington State,Pac-12,11,3,21,7.0,1,1.9,89,860,9.7,5,78.2,92,881,9.6,6,,lincoln-victor-1
978,Melquan Stovall,Arizona State,Pac-12,12,3,21,7.0,1,1.8,18,207,11.5,0,17.3,21,228,10.9,1,,melquan-stovall-1
979,Tanner McGee*,South Alabama,Sun Belt,2,2,21,10.5,0,10.5,0,0,,0,0.0,2,21,10.5,0,,tanner-mcgee-1
980,Tavierre Dunlap*,Michigan,Big Ten,10,5,21,4.2,0,2.1,0,0,,0,0.0,5,21,4.2,0,,tavierre-dunlap-1
981,Zach Vigil,New Mexico,MWC,8,7,21,3.0,0,2.6,2,11,5.5,0,1.4,9,32,3.6,0,,zach-vigil-2
982,A.J. Turner*,Marshall,Sun Belt,3,6,20,3.3,0,6.7,1,5,5.0,0,1.7,7,25,3.6,0,,aj-turner-3
983,DeAngelo Irvin Jr.*,Nevada-Las Vegas,MWC,7,2,20,10.0,0,2.9,3,37,12.3,0,5.3,5,57,11.4,0,,deangelo-irvin-jr-1
984,Emari White,UTEP,CUSA,11,2,20,10.0,0,1.8,8,132,16.5,0,12.0,10,152,15.2,0,,emari-white-1
985,Gavin Freeman*,Oklahoma,Big 12,13,5,20,4.0,0,1.5,19,95,5.0,1,7.3,24,115,4.8,1,,gavin-freeman-1
986,Jarvis Durr*,South Alabama,Sun Belt,1,3,20,6.7,0,20.0,0,0,,0,0.0,3,20,6.7,0,,jarvis-durr-1
987,Jet Harris*,Air Force,MWC,13,5,20,4.0,1,1.5,0,0,,0,0.0,5,20,4.0,1,,jet-harris-1
988,Jimmy Calloway*,Louisville,ACC,14,3,20,6.7,0,1.4,20,242,12.1,0,17.3,23,262,11.4,0,,jimmy-calloway-1
989,Kaden Wetjen*,Iowa,Big Ten,14,4,20,5.0,0,1.4,0,0,,0,0.0,4,20,5.0,0,,kaden-wetjen-1
990,Kaylon Horton,North Texas,American,12,4,20,5.0,0,1.7,6,44,7.3,1,3.7,10,64,6.4,1,,kaylon-horton-1
991,Marquis Crosby,Louisiana Tech,CUSA,1,1,20,20.0,0,20.0,0,0,,0,0.0,1,20,20.0,0,,marquis-crosby-1
992,Montravius Lloyd,Pitt,ACC,1,5,20,4.0,0,20.0,1,7,7.0,0,7.0,6,27,4.5,0,,montravius-lloyd-1
993,Nik McMillan,Buffalo,MAC,7,2,20,10.0,0,2.9,13,180,13.8,1,25.7,15,200,13.3,1,,nik-mcmillan-1
994,Tyler Buchner*,Alabama,SEC,2,3,20,6.7,1,10.0,0,0,,0,0.0,3,20,6.7,1,,tyler-buchner-1
995,Billy Wiles,Southern Mississippi,Sun Belt,11,57,19,0.3,1,1.7,0,0,,0,0.0,57,19,0.3,1,,billy-wiles-1
996,Braylin Presley,Tulsa,American,12,6,19,3.2,0,1.6,11,122,11.1,0,10.2,17,141,8.3,0,,braylin-presley-1
997,Brian Brewton,Connecticut,Ind,2,3,19,6.3,0,9.5,0,0,,0,0.0,3,19,6.3,0,,brian-brewton-1
998,Carlos Davis,Massachusetts,Ind,4,20,19,1.0,0,4.8,0,0,,0,0.0,20,19,1.0,0,,carlos-davis-5
999,D'Wanyé Winfield*,Louisiana,Sun Belt,1,5,19,3.8,0,19.0,0,0,,0,0.0,5,19,3.8,0,,dwanye-winfield-1
1000,Ethan Wright,Cincinnati,Big 12,4,7,19,2.7,0,4.8,1,10,10.0,0,2.5,8,29,3.6,0,,ethan-wright-1
1001,Jalen Bracey,Florida International,CUSA,12,4,19,4.8,0,1.6,31,316,10.2,1,26.3,35,335,9.6,1,,jalen-bracey-1
1002,Jamal Hailey,Western Michigan,MAC,10,6,19,3.2,0,1.9,0,0,,0,0.0,6,19,3.2,0,,jamal-hailey-1
1003,Jordan Jenkins,Baylor,Big 12,6,2,19,9.5,0,3.2,0,0,,0,0.0,2,19,9.5,0,,jordan-jenkins-3
1004,Justyn Martin*,UCLA,Pac-12,2,3,19,6.3,0,9.5,0,0,,0,0.0,3,19,6.3,0,,justyn-martin-1
1005,Mikele Colasurdo*,Georgia State,Sun Belt,6,4,19,4.8,1,3.2,0,0,,0,0.0,4,19,4.8,1,,mikele-colasurdo-1
1006,Rickie Collins*,LSU,SEC,1,3,19,6.3,0,19.0,0,0,,0,0.0,3,19,6.3,0,,rickie-collins-1
1007,Todd Justice*,South Alabama,Sun Belt,13,1,19,19.0,0,1.5,3,12,4.0,0,0.9,4,31,7.8,0,,todd-justice-1
1008,Casey Rogers*,Oregon,Pac-12,14,1,18,18.0,0,1.3,0,0,,0,0.0,1,18,18.0,0,,casey-rogers-2
1009,Chris Velotta*,Notre Dame,Ind,9,3,18,6.0,0,2.0,0,0,,0,0.0,3,18,6.0,0,,chris-velotta-2
1010,Cole Harrity,Buffalo,MAC,12,4,18,4.5,0,1.5,35,294,8.4,3,24.5,39,312,8.0,3,,cole-harrity-1
1011,Cole Nelson*,Virginia Tech,ACC,13,1,18,18.0,0,1.4,0,0,,0,0.0,1,18,18.0,0,,cole-nelson-1
1012,Daniel Wood*,Utah,Pac-12,5,5,18,3.6,0,3.6,0,0,,0,0.0,5,18,3.6,0,,daniel-wood-2
1013,David Holloman,Indiana,Big Ten,10,6,18,3.0,0,1.8,0,0,,0,0.0,6,18,3.0,0,,david-holloman-1
1014,Davion Primm,Michigan State,Big Ten,8,7,18,2.6,0,2.3,0,0,,0,0.0,7,18,2.6,0,,davion-primm-1
1015,Deuce Spann*,Florida State,ACC,11,5,18,3.6,0,1.6,1,23,23.0,0,2.1,6,41,6.8,0,,deuce-spann-1
1016,Elliott Nimrod*,Utah State,MWC,12,1,18,18.0,1,1.5,0,0,,0,0.0,1,18,18.0,1,,elliott-nimrod-1
1017,Gary Bryant Jr.*,Oregon,Pac-12,14,3,18,6.0,0,1.3,30,442,14.7,4,31.6,33,460,13.9,4,,gary-bryant-jr-1
1018,Jimmy Horn Jr.,Colorado,Pac-12,12,2,18,9.0,0,1.5,58,567,9.8,6,47.3,60,585,9.8,6,,jimmy-horn-jr-1
1019,Johnathan Arceneaux*,Fresno State,MWC,4,6,18,3.0,0,4.5,2,15,7.5,0,3.8,8,33,4.1,0,,johnathan-arceneaux-1
1020,Jordan Whittington*,Texas,Big 12,14,3,18,6.0,0,1.3,42,505,12.0,1,36.1,45,523,11.6,1,,jordan-whittington-2
1021,KJ Edwards,Colorado State,MWC,1,2,18,9.0,0,18.0,0,0,,0,0.0,2,18,9.0,0,,kj-edwards-1
1022,Taulia Tagovailoa*,Maryland,Big Ten,12,68,18,0.3,5,1.5,1,21,21.0,0,1.8,69,39,0.6,5,,taulia-tagovailoa-1
1023,Te'Sean Smoot*,Jacksonville State,CUSA,2,4,18,4.5,0,9.0,0,0,,0,0.0,4,18,4.5,0,,tesean-smoot-1
1024,Vinny Anthony*,Wisconsin,Big Ten,13,1,18,18.0,0,1.4,10,99,9.9,0,7.6,11,117,10.6,0,,vinny-anthony-1
1025,Ahmarian Granger*,Old Dominion,Sun Belt,13,2,17,8.5,0,1.3,15,213,14.2,1,16.4,17,230,13.5,1,,ahmarian-granger-1
1026,Ben Kiernan*,North Carolina,ACC,5,1,17,17.0,0,3.4,0,0,,0,0.0,1,17,17.0,0,,ben-kiernan-1
1027,Grayson Loftis*,Duke,ACC,8,20,17,0.9,1,2.1,0,0,,0,0.0,20,17,0.9,1,,grayson-loftis-1
1028,Hayden Wolff,Western Michigan,MAC,8,44,17,0.4,2,2.1,0,0,,0,0.0,44,17,0.4,2,,hayden-wolff-1
1029,Hunter Barnes*,Tennessee,SEC,1,4,17,4.3,0,17.0,0,0,,0,0.0,4,17,4.3,0,,hunter-barnes-1
1030,Iverson Celestine*,Tulane,American,2,4,17,4.3,0,8.5,0,0,,0,0.0,4,17,4.3,0,,iverson-celestine-1
1031,Jackson Kleather*,Bowling Green,MAC,10,1,17,17.0,0,1.7,0,0,,0,0.0,1,17,17.0,0,,jackson-kleather-1
1032,Lamar Sperling,Buffalo,MAC,2,4,17,4.3,0,8.5,0,0,,0,0.0,4,17,4.3,0,,lamar-sperling-1
1033,Landon Brown,Sam Houston,CUSA,2,9,17,1.9,0,8.5,3,13,4.3,0,6.5,12,30,2.5,0,,landon-brown-2
1034,Lieghton Bechdel*,West Virginia,Big 12,7,1,17,17.0,0,2.4,0,0,,0,0.0,1,17,17.0,0,,lieghton-bechdel-1
1035,Malik Rutherford*,Georgia Tech,ACC,13,3,17,5.7,0,1.3,46,502,10.9,4,38.6,49,519,10.6,4,,malik-rutherford-1
1036,Matthew Shipley,Hawaii,MWC,13,1,17,17.0,0,1.3,0,0,,0,0.0,1,17,17.0,0,,matthew-shipley-1
1037,Micah Barnett*,Rice,American,13,6,17,2.8,0,1.3,0,0,,0,0.0,6,17,2.8,0,,micah-barnett-1
1038,Monaray Baldwin,Baylor,Big 12,12,3,17,5.7,0,1.4,38,623,16.4,4,51.9,41,640,15.6,4,,monaray-baldwin-1
1039,AJ Swann,Vanderbilt,SEC,6,27,16,0.6,1,2.7,0,0,,0,0.0,27,16,0.6,1,,aj-swann-1
1040,Billy Atkins*,James Madison,Sun Belt,4,3,16,5.3,0,4.0,0,0,,0,0.0,3,16,5.3,0,,billy-atkins-2
1041,Bryson Graves*,Coastal Carolina,Sun Belt,13,4,16,4.0,0,1.2,2,15,7.5,0,1.2,6,31,5.2,0,,bryson-graves-1
1042,Donte Hawthorne,Virginia,ACC,1,4,16,4.0,0,16.0,0,0,,0,0.0,4,16,4.0,0,,donte-hawthorne-1
1043,Easton Messer*,Western Kentucky,CUSA,13,2,16,8.0,0,1.2,42,484,11.5,4,37.2,44,500,11.4,4,,easton-messer-1
1044,Hunter Helms*,Clemson,ACC,4,1,16,16.0,0,4.0,0,0,,0,0.0,1,16,16.0,0,,hunter-helms-1
1045,Jabre Barber*,Troy,Sun Belt,14,3,16,5.3,0,1.1,75,999,13.3,5,71.4,78,1015,13.0,5,,jabre-barber-1
1046,Jarrad Baker*,UCF,Big 12,12,4,16,4.0,0,1.3,7,45,6.4,0,3.8,11,61,5.5,0,,jarrad-baker-1
1047,John Adams,Temple,American,11,1,16,16.0,0,1.5,15,149,9.9,2,13.5,16,165,10.3,2,,john-adams-7
1048,Quran Boyd*,Duke,ACC,1,6,16,2.7,0,16.0,0,0,,0,0.0,6,16,2.7,0,,quran-boyd-1
1049,Raleek Brown*,USC,Pac-12,2,3,16,5.3,1,8.0,3,18,6.0,0,9.0,6,34,5.7,1,,raleek-brown-1
1050,Tai Felton*,Maryland,Big Ten,13,1,16,16.0,0,1.2,48,723,15.1,6,55.6,49,739,15.1,6,,tai-felton-1
1051,Tyler Bradley,Navy,American,12,2,16,8.0,0,1.3,3,20,6.7,0,1.7,5,36,7.2,0,,tyler-bradley-1
1052,Tyler Van Dyke*,Miami (FL),ACC,11,24,16,0.7,1,1.5,0,15,,0,1.4,24,31,1.3,1,,tyler-van-dyke-1
1053,Bryson Donnell*,Texas Tech,Big 12,13,4,15,3.8,0,1.2,0,0,,0,0.0,4,15,3.8,0,,bryson-donnell-1
1054,Carlson Joseph,Florida,SEC,1,3,15,5.0,0,15.0,0,0,,0,0.0,3,15,5.0,0,,carlson-joseph-1
1055,Demeer Blankumsee*,Memphis,American,13,2,15,7.5,0,1.2,53,901,17.0,7,69.3,55,916,16.7,7,,demeer-blankumsee-1
1056,Jack Coulson,Kent State,MAC,11,1,15,15.0,0,1.4,2,10,5.0,0,0.9,3,25,8.3,0,,jack-coulson-1
1057,Jalen Montgomery,Middle Tennessee State,CUSA,12,5,15,3.0,0,1.3,0,0,,0,0.0,5,15,3.0,0,,jalen-montgomery-2
1058,Je'Quan Burton,Florida Atlantic,American,11,1,15,15.0,0,1.4,24,277,11.5,2,25.2,25,292,11.7,2,,jequan-burton-1
1059,Konata Mumpfield,Pitt,ACC,12,1,15,15.0,0,1.3,44,576,13.1,5,48.0,45,591,13.1,5,,konata-mumpfield-1
1060,Michael Kern,Wake Forest,ACC,4,27,15,0.6,0,3.8,0,0,,0,0.0,27,15,0.6,0,,michael-kern-1
1061,MJ Morris*,North Carolina State,ACC,4,32,15,0.5,0,3.8,0,0,,0,0.0,32,15,0.5,0,,mj-morris-1
1062,Navy Shuler*,Tennessee,SEC,1,2,15,7.5,0,15.0,0,0,,0,0.0,2,15,7.5,0,,navy-shuler-1
1063,PJ Johnson III*,New Mexico State,CUSA,9,1,15,15.0,0,1.7,2,13,6.5,0,1.4,3,28,9.3,0,,pj-johnson-iii-1
1064,Trapper Pannell,Sam Houston,CUSA,6,12,15,1.3,3,2.5,0,0,,0,0.0,12,15,1.3,3,,trapper-pannell-1
1065,Xavier Coleman*,Boston College,ACC,3,6,15,2.5,1,5.0,1,5,5.0,0,1.7,7,20,2.9,1,,xavier-coleman-2
1066,Xavier Weaver,Colorado,Pac-12,11,2,15,7.5,2,1.4,68,908,13.4,4,82.5,70,923,13.2,6,,xavier-weaver-1
1067,AJ Padgett*,Rice,American,6,32,14,0.4,2,2.3,0,0,,0,0.0,32,14,0.4,2,,aj-padgett-1
1068,A'Marion Peterson*,USC,Pac-12,2,2,14,7.0,0,7.0,0,0,,0,0.0,2,14,7.0,0,,amarion-peterson-1
1069,Brandon High*,UTSA,American,2,6,14,2.3,0,7.0,0,0,,0,0.0,6,14,2.3,0,,brandon-high-1
1070,Cam Barfield*,Boston College,ACC,3,11,14,1.3,0,4.7,1,-1,-1.0,0,-0.3,12,13,1.1,0,,cam-barfield-1
1071,Colton Spangler*,Maryland,Big Ten,13,1,14,14.0,0,1.1,0,0,,0,0.0,1,14,14.0,0,,colton-spangler-1
1072,Eddie Battle,Florida,SEC,2,6,14,2.3,0,7.0,0,0,,0,0.0,6,14,2.3,0,,eddie-battle-1
1073,Jackson Muschamp*,Georgia,SEC,1,1,14,14.0,0,14.0,0,0,,0,0.0,1,14,14.0,0,,jackson-muschamp-1
1074,Jacolby George*,Miami (FL),ACC,13,1,14,14.0,1,1.1,57,864,15.2,8,66.5,58,878,15.1,9,,jacolby-george-1
1075,Jesiah Irish*,Oregon State,Pac-12,12,5,14,2.8,0,1.2,18,302,16.8,1,25.2,23,316,13.7,1,,jesiah-irish-1
1076,Jordon Simmons,Michigan State,Big Ten,4,7,14,2.0,0,3.5,0,0,,0,0.0,7,14,2.0,0,,jordon-simmons-1
1077,Kacper Rutkiewicz*,Northern Illinois,MAC,6,2,14,7.0,0,2.3,21,319,15.2,2,53.2,23,333,14.5,2,,kacper-rutkiewicz-1
1078,Kalib Hicks*,Oklahoma,Big 12,2,3,14,4.7,1,7.0,0,0,,0,0.0,3,14,4.7,1,,kalib-hicks-1
1079,La'James White*,Kansas State,Big 12,7,3,14,4.7,0,2.0,0,0,,0,0.0,3,14,4.7,0,,lajames-white-1
1080,Nyny Davis,Louisiana-Monroe,Sun Belt,12,1,14,14.0,0,1.2,28,222,7.9,2,18.5,29,236,8.1,2,,nyny-davis-1
1081,Billy Kemp,Nebraska,Big Ten,11,3,13,4.3,1,1.2,35,310,8.9,1,28.2,38,323,8.5,2,,billy-kemp-2
1082,Cam Crooks,Tulsa,American,4,4,13,3.3,0,3.3,0,0,,0,0.0,4,13,3.3,0,,cam-crooks-1
1083,David Martin-Robinson,Temple,American,12,9,13,1.4,1,1.1,40,537,13.4,4,44.8,49,550,11.2,5,,david-martin-robinson-1
1084,Dee Wiggins,Cincinnati,Big 12,12,1,13,13.0,0,1.1,20,246,12.3,2,20.5,21,259,12.3,2,,dee-wiggins-2
1085,J.J. Pegues*,Ole Miss,SEC,13,4,13,3.3,0,1.0,0,0,,0,0.0,4,13,3.3,0,,jj-pegues-1
1086,Luke Floriea,Kent State,MAC,12,1,13,13.0,1,1.1,39,413,10.6,4,34.4,40,426,10.7,5,,luke-floriea-1
1087,Nate Yarnell,Pitt,ACC,4,19,13,0.7,1,3.3,0,0,,0,0.0,19,13,0.7,1,,nate-yarnell-1
1088,Squirrel White*,Tennessee,SEC,13,2,13,6.5,0,1.0,67,803,12.0,2,61.8,69,816,11.8,2,,squirrel-white-1
1089,Stephon Johnson Jr.,Houston,Big 12,12,1,13,13.0,0,1.1,24,277,11.5,3,23.1,25,290,11.6,3,,stephon-johnson-jr-1
1090,Tobin O'Dell,San Diego State,MWC,3,4,13,3.3,0,4.3,0,0,,0,0.0,4,13,3.3,0,,tobin-odell-1
1091,Ahmad Edwards,Ball State,MAC,12,2,12,6.0,0,1.0,31,354,11.4,1,29.5,33,366,11.1,1,,ahmad-edwards-1
1092,Brock Domann*,Louisville,ACC,4,3,12,4.0,0,3.0,0,0,,0,0.0,3,12,4.0,0,,brock-domann-1
1093,Chase Roberts,BYU,Big 12,12,2,12,6.0,0,1.0,42,573,13.6,5,47.8,44,585,13.3,5,,chase-roberts-2
1094,Deion Burks,Purdue,Big Ten,12,4,12,3.0,0,1.0,47,629,13.4,7,52.4,51,641,12.6,7,,deion-burks-1
1095,Dino Tomlin*,Boston College,ACC,13,3,12,4.0,0,0.9,24,312,13.0,0,24.0,27,324,12.0,0,,dino-tomlin-1
1096,Earnest Crownover*,Texas A&M,SEC,13,4,12,3.0,0,0.9,2,21,10.5,2,1.6,6,33,5.5,2,,earnest-crownover-1
1097,Elijah Green*,North Carolina,ACC,4,4,12,3.0,0,3.0,0,0,,0,0.0,4,12,3.0,0,,elijah-green-1
1098,Issiah Nixon,Sam Houston,CUSA,12,7,12,1.7,2,1.0,0,0,,0,0.0,7,12,1.7,2,,issiah-nixon-1
1099,Jake Tafelski,Central Michigan,MAC,11,3,12,4.0,0,1.1,1,0,0.0,0,0.0,4,12,3.0,0,,jake-tafelski-1
1100,Jamari Thrash*,Louisville,ACC,12,1,12,12.0,1,1.0,63,858,13.6,6,71.5,64,870,13.6,7,,jamari-thrash-1
1101,Jared Rayman,Virginia,ACC,12,3,12,4.0,0,1.0,0,0,,0,0.0,3,12,4.0,0,,jared-rayman-1
1102,Ja'Tavion Sanders*,Texas,Big 12,14,1,12,12.0,0,0.9,45,682,15.2,2,48.7,46,694,15.1,2,,jatavion-sanders-1
1103,Ja'Varrius Johnson*,Auburn,SEC,10,1,12,12.0,1,1.2,19,347,18.3,3,34.7,20,359,18.0,4,,javarrius-johnson-1
1104,John Paul Richardson,TCU,Big 12,12,3,12,4.0,0,1.0,46,536,11.7,3,44.7,49,548,11.2,3,,john-paul-richardson-1
1105,Jojo Earle,TCU,Big 12,12,3,12,4.0,0,1.0,16,239,14.9,2,19.9,19,251,13.2,2,,jojo-earle-1
1106,Keldric Luster*,SMU,American,2,2,12,6.0,0,6.0,0,0,,0,0.0,2,12,6.0,0,,keldric-luster-1
1107,Kellan Hood*,North Carolina,ACC,1,2,12,6.0,0,12.0,1,3,3.0,0,3.0,3,15,5.0,0,,kellan-hood-1
1108,Kenyon Sadiq*,Oregon,Pac-12,14,1,12,12.0,0,0.9,5,24,4.8,1,1.7,6,36,6.0,1,,kenyon-sadiq-1
1109,Odieu Hiliare*,Bowling Green,MAC,13,1,12,12.0,0,0.9,45,532,11.8,4,40.9,46,544,11.8,4,,odieu-hiliare-1
1110,Shaun Thomas,Cincinnati,Big 12,7,7,12,1.7,0,1.7,0,0,,0,0.0,7,12,1.7,0,,shaun-thomas-1
1111,Tayvion Robinson*,Kentucky,SEC,13,2,12,6.0,0,0.9,41,552,13.5,4,42.5,43,564,13.1,4,,tayvion-robinson-1
1112,Terron Dixon II*,Georgia Southern,Sun Belt,1,5,12,2.4,0,12.0,0,0,,0,0.0,5,12,2.4,0,,terron-dixon-ii-1
1113,Traeshon Holden*,Oregon,Pac-12,14,2,12,6.0,1,0.9,37,452,12.2,6,32.3,39,464,11.9,7,,traeshon-holden-1
1114,Yasias Young*,South Florida,American,10,4,12,3.0,0,1.2,0,0,,0,0.0,4,12,3.0,0,,yasias-young-1
1115,Antwan Roberts*,Marshall,Sun Belt,4,2,11,5.5,0,2.8,1,17,17.0,0,4.3,3,28,9.3,0,,antwan-roberts-2
1116,Ayir Asante*,Wyoming,MWC,13,4,11,2.8,1,0.8,21,372,17.7,6,28.6,25,383,15.3,7,,ayir-asante-1
1117,Charles Crawford,Sam Houston,CUSA,3,7,11,1.6,0,3.7,1,18,18.0,0,6.0,8,29,3.6,0,,charles-crawford-4
1118,Charlie Offerdahl,Colorado,Pac-12,8,2,11,5.5,0,1.4,0,0,,0,0.0,2,11,5.5,0,,charlie-offerdahl-1
1119,Christian Washington,New Mexico,MWC,2,12,11,0.9,0,5.5,1,3,3.0,0,1.5,13,14,1.1,0,,christian-washington-1
1120,Dakota Williams,Louisiana Tech,CUSA,11,8,11,1.4,1,1.0,0,0,,0,0.0,8,11,1.4,1,,dakota-williams-1
1121,Dedrick Latulas,Louisiana Tech,CUSA,10,3,11,3.7,0,1.1,3,-2,-0.7,0,-0.2,6,9,1.5,0,,dedrick-latulas-1
1122,Duane Thomas Jr.,Charlotte,American,12,5,11,2.2,0,0.9,24,244,10.2,0,20.3,29,255,8.8,0,,duane-thomas-jr-1
1123,George Hart III,Arizona State,Pac-12,3,7,11,1.6,0,3.7,1,5,5.0,0,1.7,8,16,2.0,0,,george-hart-iii-1
1124,Jake Arthurs*,Northwestern,Big Ten,2,4,11,2.8,0,5.5,0,0,,0,0.0,4,11,2.8,0,,jake-arthurs-1
1125,Jaylen Lloyd,Nebraska,Big Ten,10,4,11,2.8,0,1.1,6,237,39.5,3,23.7,10,248,24.8,3,,jaylen-lloyd-1
1126,John Busha*,Air Force,MWC,4,13,11,0.8,1,2.8,0,0,,0,0.0,13,11,0.8,1,,john-busha-1
1127,Kaden Cloud*,Air Force,MWC,1,2,11,5.5,0,11.0,0,0,,0,0.0,2,11,5.5,0,,kaden-cloud-1
1128,Kobie Campbell*,Rice,American,11,8,11,1.4,0,1.0,11,164,14.9,1,14.9,19,175,9.2,1,,kobie-campbell-1
1129,Luke Bottari*,Utah,Pac-12,2,5,11,2.2,2,5.5,0,0,,0,0.0,5,11,2.2,2,,luke-bottari-1
1130,Malachi Corley*,Western Kentucky,CUSA,12,4,11,2.8,0,0.9,79,984,12.5,11,82.0,83,995,12.0,11,,malachi-corley-1
1131,Mudia Reuben,Stanford,Pac-12,10,2,11,5.5,0,1.1,15,199,13.3,0,19.9,17,210,12.4,0,,mudia-reuben-1
1132,Nate Boerkircher,Nebraska,Big Ten,12,1,11,11.0,0,0.9,5,51,10.2,0,4.3,6,62,10.3,0,,nate-boerkircher-1
1133,Nazar Bombata*,Arizona,Pac-12,13,1,11,11.0,0,0.8,0,0,,0,0.0,1,11,11.0,0,,nazar-bombata-1
1134,Will Pauling*,Wisconsin,Big Ten,13,1,11,11.0,0,0.8,74,837,11.3,6,64.4,75,848,11.3,6,,will-pauling-1
1135,Ajani Sheppard*,Rutgers,Big Ten,1,1,10,10.0,0,10.0,0,0,,0,0.0,1,10,10.0,0,,ajani-sheppard-1
1136,Dashaun Davis*,Appalachian State,Sun Belt,13,1,10,10.0,0,0.8,29,381,13.1,3,29.3,30,391,13.0,3,,dashaun-davis-1
1137,Devin McCuin*,UTSA,American,12,1,10,10.0,0,0.8,42,546,13.0,3,45.5,43,556,12.9,3,,devin-mccuin-1
1138,Eli Mason*,Maryland,Big Ten,10,3,10,3.3,0,1.0,0,0,,0,0.0,3,10,3.3,0,,eli-mason-1
1139,Jake Bailey*,SMU,American,14,1,10,10.0,0,0.7,42,528,12.6,0,37.7,43,538,12.5,0,,jake-bailey-2
1140,Jaquaize Pettaway*,Oklahoma,Big 12,9,1,10,10.0,0,1.1,11,70,6.4,0,7.8,12,80,6.7,0,,jaquaize-pettaway-1
1141,Jayden Denegal*,Michigan,Big Ten,6,4,10,2.5,0,1.7,0,0,,0,0.0,4,10,2.5,0,,jayden-denegal-1
1142,Jayden Thomas*,Notre Dame,Ind,11,1,10,10.0,0,0.9,21,310,14.8,2,28.2,22,320,14.5,2,,jayden-thomas-1
1143,Jeremiah Hixon,New Mexico,MWC,11,2,10,5.0,0,0.9,39,482,12.4,5,43.8,41,492,12.0,5,,jeremiah-hixon-2
1144,Julian Gray*,North Carolina State,ACC,11,3,10,3.3,0,0.9,16,170,10.6,1,15.5,19,180,9.5,1,,julian-gray-1
1145,Kadin Semonza,Ball State,MAC,4,17,10,0.6,0,2.5,0,0,,0,0.0,17,10,0.6,0,,kadin-semonza-1
1146,Kendrell Flowers*,Northern Illinois,MAC,1,3,10,3.3,0,10.0,1,3,3.0,0,3.0,4,13,3.3,0,,kendrell-flowers-2
1147,Lawrence Arnold*,Kansas,Big 12,13,1,10,10.0,0,0.8,44,782,17.8,6,60.2,45,792,17.6,6,,lawrence-arnold-2
1148,Nyck Harbor,South Carolina,SEC,12,2,10,5.0,0,0.8,12,195,16.3,1,16.3,14,205,14.6,1,,nyck-harbor-1
1149,Oscar Chapman*,Auburn,SEC,13,1,10,10.0,0,0.8,0,0,,0,0.0,1,10,10.0,0,,oscar-chapman-1
1150,Roman Wilson*,Michigan,Big Ten,15,1,10,10.0,0,0.7,48,789,16.4,12,52.6,49,799,16.3,12,,roman-wilson-1
1151,Tahj Washington*,USC,Pac-12,13,1,10,10.0,0,0.8,59,1062,18.0,8,81.7,60,1072,17.9,8,,tahj-washington-1
1152,Timmy Bleekrode,Nebraska,Big Ten,3,1,10,10.0,0,3.3,0,0,,0,0.0,1,10,10.0,0,,timmy-bleekrode-1
1153,Tony Johnson,Florida Atlantic,American,12,1,10,10.0,0,0.8,37,411,11.1,4,34.3,38,421,11.1,4,,tony-johnson-10
1154,Trent Hudson*,New Mexico State,CUSA,14,1,10,10.0,0,0.7,36,571,15.9,10,40.8,37,581,15.7,10,,trent-hudson-1
1155,Trey Lowe III*,Liberty,CUSA,2,3,10,3.3,0,5.0,0,0,,0,0.0,3,10,3.3,0,,trey-lowe-iii-1
1156,Anthony Venneri,Buffalo,MAC,12,1,9,9.0,0,0.8,0,0,,0,0.0,1,9,9.0,0,,anthony-venneri-1
1157,Atticus Sappington*,Oregon State,Pac-12,12,1,9,9.0,0,0.8,0,0,,0,0.0,1,9,9.0,0,,atticus-sappington-1
1158,Bryce McMahon*,Toledo,MAC,1,3,9,3.0,0,9.0,0,0,,0,0.0,3,9,3.0,0,,bryce-mcmahon-1
1159,Caleb Komolafe*,Northwestern,Big Ten,4,4,9,2.3,0,2.3,5,33,6.6,1,8.3,9,42,4.7,1,,caleb-komolafe-1
1160,Cameron Ross,Connecticut,Ind,12,4,9,2.3,0,0.8,44,552,12.5,1,46.0,48,561,11.7,1,,cameron-ross-1
1161,Champ Harris,Army,Ind,6,21,9,0.4,1,1.5,0,0,,0,0.0,21,9,0.4,1,,champ-harris-1
1162,Chase Gabriel,Florida International,CUSA,11,1,9,9.0,0,0.8,0,0,,0,0.0,1,9,9.0,0,,chase-gabriel-1
1163,Chase Ketterer*,Notre Dame,Ind,10,2,9,4.5,1,0.9,1,4,4.0,0,0.4,3,13,4.3,1,,chase-ketterer-1
1164,Eric Singleton Jr.*,Georgia Tech,ACC,12,1,9,9.0,0,0.8,48,714,14.9,6,59.5,49,723,14.8,6,,eric-singleton-jr-1
1165,Jake Farrell,Hawaii,MWC,1,2,9,4.5,0,9.0,0,0,,0,0.0,2,9,4.5,0,,jake-farrell-1
1166,Janiran Bonner,Nebraska,Big Ten,12,4,9,2.3,1,0.8,1,5,5.0,0,0.4,5,14,2.8,1,,janiran-bonner-1
1167,Joseph Bearns III,Charlotte,American,12,3,9,3.0,0,0.8,3,8,2.7,0,0.7,6,17,2.8,0,,joseph-bearns-iii-1
1168,Kayden Collins*,San Jose State,MWC,11,2,9,4.5,0,0.8,0,0,,0,0.0,2,9,4.5,0,,kayden-collins-1
1169,Malik Phillips,Sam Houston,CUSA,12,3,9,3.0,0,0.8,35,430,12.3,1,35.8,38,439,11.6,1,,malik-phillips-1
1170,Mark Pope,Massachusetts,Ind,12,5,9,1.8,0,0.8,33,420,12.7,1,35.0,38,429,11.3,1,,mark-pope-1
1171,Raheim Jeter,East Carolina,American,1,1,9,9.0,0,9.0,0,0,,0,0.0,1,9,9.0,0,,raheim-jeter-1
1172,Simeon Evans,Sam Houston,CUSA,10,1,9,9.0,0,0.9,22,188,8.5,0,18.8,23,197,8.6,0,,simeon-evans-1
1173,Steven Johnson,Charlotte,American,1,3,9,3.0,0,9.0,0,0,,0,0.0,3,9,3.0,0,,steven-johnson-4
1174,Timothy Conerly*,Nevada-Las Vegas,MWC,11,2,9,4.5,0,0.8,8,80,10.0,0,7.3,10,89,8.9,0,,timothy-conerly-1
1175,Troy Leigber*,UCLA,Pac-12,1,1,9,9.0,0,9.0,0,0,,0,0.0,1,9,9.0,0,,troy-leigber-1
1176,Tyrone Broden,Arkansas,SEC,12,1,9,9.0,0,0.8,15,109,7.3,3,9.1,16,118,7.4,3,,tyrone-broden-1
1177,Zach Haynes*,New Mexico State,CUSA,15,1,9,9.0,0,0.6,0,0,,0,0.0,1,9,9.0,0,,zach-haynes-2
1178,Ben Finley*,California,Pac-12,7,12,8,0.7,0,1.1,0,0,,0,0.0,12,8,0.7,0,,ben-finley-1
1179,Bradley Dunn,South Carolina,SEC,6,3,8,2.7,0,1.3,0,0,,0,0.0,3,8,2.7,0,,bradley-dunn-1
1180,Bryson Moss*,Eastern Michigan,MAC,4,1,8,8.0,0,2.0,0,0,,0,0.0,1,8,8.0,0,,bryson-moss-1
1181,Cade McDonald*,Miami (OH),MAC,13,2,8,4.0,0,0.6,28,355,12.7,3,27.3,30,363,12.1,3,,cade-mcdonald-1
1182,Cam Johnson*,Northwestern,Big Ten,13,1,8,8.0,0,0.6,54,715,13.2,6,55.0,55,723,13.1,6,,cam-johnson-2
1183,Chauncy Cobb*,Arkansas State,Sun Belt,1,1,8,8.0,0,8.0,0,0,,0,0.0,1,8,8.0,0,,chauncy-cobb-1
1184,Chuuky Hines,Hawaii,MWC,12,1,8,8.0,0,0.7,9,92,10.2,1,7.7,10,100,10.0,1,,chuuky-hines-1
1185,C.J. Stokes*,Michigan,Big Ten,2,4,8,2.0,0,4.0,0,0,,0,0.0,4,8,2.0,0,,cj-stokes-1
1186,Cooper DeJean*,Iowa,Big Ten,10,1,8,8.0,0,0.8,0,0,,0,0.0,1,8,8.0,0,AA,cooper-dejean-1
1187,Danny Hughes*,Michigan,Big Ten,12,2,8,4.0,0,0.7,0,0,,0,0.0,2,8,4.0,0,,danny-hughes-1
1188,Derrick Davis Jr.,Pitt,ACC,8,2,8,4.0,0,1.0,0,0,,0,0.0,2,8,4.0,0,,derrick-davis-jr-1
1189,Dewayne Coleman,Army,Ind,3,4,8,2.0,0,2.7,0,-10,,0,-3.3,4,-2,-0.5,0,,dewayne-coleman-1
1190,Drake Stoops*,Oklahoma,Big 12,13,4,8,2.0,0,0.6,84,962,11.5,10,74.0,88,970,11.0,10,,drake-stoops-1
1191,EJ Horton*,West Virginia,Big 12,11,2,8,4.0,0,0.7,10,201,20.1,1,18.3,12,209,17.4,1,,ej-horton-2
1192,Emmett Morehead*,Boston College,ACC,4,2,8,4.0,0,2.0,0,0,,0,0.0,2,8,4.0,0,,emmett-morehead-1
1193,Javen Jacobs,Arizona State,Pac-12,5,3,8,2.7,0,1.6,0,0,,0,0.0,3,8,2.7,0,,javen-jacobs-1
1194,Jayden Harrison*,Marshall,Sun Belt,13,1,8,8.0,0,0.6,28,410,14.6,1,31.5,29,418,14.4,1,,jayden-harrison-1
1195,Jaylen Johnson*,South Florida,American,1,2,8,4.0,0,8.0,0,0,,0,0.0,2,8,4.0,0,,jaylen-johnson-6
1196,Jonathon Carter*,South Alabama,Sun Belt,1,1,8,8.0,0,8.0,0,0,,0,0.0,1,8,8.0,0,,jonathon-carter-1
1197,Kamdyn Benjamin,Tulsa,American,12,1,8,8.0,0,0.7,47,727,15.5,6,60.6,48,735,15.3,6,,kamdyn-benjamin-1
1198,Kenyon Sims*,Jacksonville State,CUSA,4,4,8,2.0,0,2.0,0,0,,0,0.0,4,8,2.0,0,,kenyon-sims-1
1199,Max Fletcher,Arkansas,SEC,12,1,8,8.0,0,0.7,0,0,,0,0.0,1,8,8.0,0,,max-fletcher-1
1200,Michael Penix Jr.*,Washington,Pac-12,15,35,8,0.2,3,0.5,0,0,,0,0.0,35,8,0.2,3,H-2Maxwell,michael-penix-jr-1
1201,Monroe Young*,California,Pac-12,13,3,8,2.7,0,0.6,19,208,10.9,1,16.0,22,216,9.8,1,,monroe-young-1
1202,Noah Short,Army,Ind,12,3,8,2.7,0,0.7,18,252,14.0,2,21.0,21,260,12.4,2,,noah-short-1
1203,Que Williams*,Miami (OH),MAC,1,1,8,8.0,0,8.0,0,0,,0,0.0,1,8,8.0,0,,que-williams-1
1204,Quentin Skinner*,Kansas,Big 12,13,2,8,4.0,0,0.6,29,587,20.2,2,45.2,31,595,19.2,2,,quentin-skinner-2
1205,Reese Clark,Temple,American,12,3,8,2.7,0,0.7,18,145,8.1,1,12.1,21,153,7.3,1,,reese-clark-1
1206,Tamatoa Mokiao-Atimalala,Hawaii,MWC,11,1,8,8.0,1,0.7,4,24,6.0,0,2.2,5,32,6.4,1,,tamatoa-mokiao-atimalala-1
1207,Tar'Varish Dawson Jr.,Colorado,Pac-12,7,1,8,8.0,1,1.1,14,124,8.9,1,17.7,15,132,8.8,2,,tarvarish-dawson-jr-1
1208,Tate Jernigan*,Tulane,American,1,1,8,8.0,0,8.0,0,0,,0,0.0,1,8,8.0,0,,tate-jernigan-1
1209,Arch Manning*,Texas,Big 12,2,3,7,2.3,0,3.5,0,0,,0,0.0,3,7,2.3,0,,arch-manning-1
1210,Bennett Meredith,Purdue,Big Ten,3,4,7,1.8,0,2.3,0,0,,0,0.0,4,7,1.8,0,,bennett-meredith-1
1211,Bobby Golden,Akron,MAC,12,2,7,3.5,0,0.6,17,144,8.5,0,12.0,19,151,7.9,0,,bobby-golden-2
1212,Davis Beville*,Oklahoma,Big 12,2,3,7,2.3,0,3.5,0,0,,0,0.0,3,7,2.3,0,,davis-beville-1
1213,E.J. Warner,Temple,American,10,24,7,0.3,0,0.7,0,0,,0,0.0,24,7,0.3,0,,ej-warner-1
1214,George Arata*,Tulane,American,1,2,7,3.5,0,7.0,0,0,,0,0.0,2,7,3.5,0,,george-arata-1
1215,Grady Brosterhous,Virginia,ACC,6,4,7,1.8,0,1.2,0,0,,0,0.0,4,7,1.8,0,,grady-brosterhous-1
1216,Hamze El-Zayat*,Eastern Michigan,MAC,13,2,7,3.5,0,0.5,27,360,13.3,2,27.7,29,367,12.7,2,,hamze-el-zayat-2
1217,Iverson Hooks,UAB,American,3,1,7,7.0,0,2.3,10,106,10.6,2,35.3,11,113,10.3,2,,iverson-hooks-1
1218,Jahmal Banks,Wake Forest,ACC,12,1,7,7.0,0,0.6,59,653,11.1,4,54.4,60,660,11.0,4,,jahmal-banks-1
1219,Jakobie Seabourn*,Syracuse,ACC,5,4,7,1.8,0,1.4,0,0,,0,0.0,4,7,1.8,0,,jakobie-seabourn-1
1220,Jalen Johnson*,Air Force,MWC,12,2,7,3.5,0,0.6,0,0,,0,0.0,2,7,3.5,0,,jalen-johnson-7
1221,Jaylin Belford*,Liberty,CUSA,2,1,7,7.0,0,3.5,0,0,,0,0.0,1,7,7.0,0,,jaylin-belford-1
1222,Josh Nicholson,San Diego State,MWC,12,2,7,3.5,0,0.6,13,113,8.7,1,9.4,15,120,8.0,1,,josh-nicholson-1
1223,Justin Ibieta*,Tulane,American,3,2,7,3.5,0,2.3,0,0,,0,0.0,2,7,3.5,0,,justin-ibieta-1
1224,Kelly Akharaiyi,UTEP,CUSA,12,1,7,7.0,0,0.6,48,1033,21.5,7,86.1,49,1040,21.2,7,,kelly-akharaiyi-1
1225,Ke'Marion Baldwin*,James Madison,Sun Belt,4,3,7,2.3,0,1.8,0,0,,0,0.0,3,7,2.3,0,,kemarion-baldwin-1
1226,Malik Washington,Virginia,ACC,12,3,7,2.3,0,0.6,110,1426,13.0,9,118.8,113,1433,12.7,9,,malik-washington-1
1227,Matt Colombo*,USC,Pac-12,4,1,7,7.0,0,1.8,0,0,,0,0.0,1,7,7.0,0,,matt-colombo-1
1228,Nolan Ray*,Maryland,Big Ten,1,3,7,2.3,0,7.0,0,0,,0,0.0,3,7,2.3,0,,nolan-ray-1
1229,Sam Pinckney*,Coastal Carolina,Sun Belt,13,1,7,7.0,0,0.5,72,1027,14.3,8,79.0,73,1034,14.2,8,,sam-pinckney-1
1230,Tristan Cox*,Ohio,MAC,12,1,7,7.0,0,0.6,0,0,,0,0.0,1,7,7.0,0,,tristan-cox-2
1231,Tychaun Chapman*,North Carolina,ACC,12,1,7,7.0,0,0.6,7,135,19.3,1,11.3,8,142,17.8,1,,tychaun-chapman-1
1232,Tyler Harrell*,Miami (FL),ACC,8,1,7,7.0,0,0.9,4,45,11.3,0,5.6,5,52,10.4,0,,tyler-harrell-1
1233,Zae Baines,Temple,American,11,2,7,3.5,0,0.6,36,442,12.3,1,40.2,38,449,11.8,1,,zae-baines-1
1234,Abdul-Fatai Ibrahim*,Bowling Green,MAC,13,3,6,2.0,0,0.5,20,220,11.0,2,16.9,23,226,9.8,2,,abdul-fatai-ibrahim-1
1235,Andrew Glass,Kent State,MAC,12,2,6,3.0,0,0.5,0,0,,0,0.0,2,6,3.0,0,,andrew-glass-1
1236,Arlen Harris*,Iowa State,Big 12,6,1,6,6.0,0,1.0,0,0,,0,0.0,1,6,6.0,0,,arlen-harris-2
1237,Beau Nelson,Stanford,Pac-12,1,1,6,6.0,0,6.0,0,0,,0,0.0,1,6,6.0,0,,beau-nelson-1
1238,Chase Contreraz*,Iowa State,Big 12,13,1,6,6.0,0,0.5,0,0,,0,0.0,1,6,6.0,0,,chase-contreraz-1
1239,Cole Cabana*,Michigan,Big Ten,1,2,6,3.0,0,6.0,0,0,,0,0.0,2,6,3.0,0,,cole-cabana-1
1240,Corey Rucker*,Arkansas State,Sun Belt,13,1,6,6.0,0,0.5,36,705,19.6,2,54.2,37,711,19.2,2,,corey-rucker-1
1241,Dalton Stroman*,Appalachian State,Sun Belt,14,1,6,6.0,0,0.4,20,390,19.5,3,27.9,21,396,18.9,3,,dalton-stroman-1
1242,Darius Stone*,Air Force,MWC,1,1,6,6.0,0,6.0,0,0,,0,0.0,1,6,6.0,0,,darius-stone-1
1243,Darren Lloyd*,Coastal Carolina,Sun Belt,1,2,6,3.0,0,6.0,0,0,,0,0.0,2,6,3.0,0,,darren-lloyd-1
1244,Emeka Megwa*,Oklahoma,Big 12,1,1,6,6.0,0,6.0,0,0,,0,0.0,1,6,6.0,0,,emeka-megwa-1
1245,Ethan Hampton*,Northern Illinois,MAC,4,4,6,1.5,0,1.5,0,0,,0,0.0,4,6,1.5,0,,ethan-hampton-1
1246,Gavin Haines*,Oregon State,Pac-12,2,2,6,3.0,0,3.0,0,0,,0,0.0,2,6,3.0,0,,gavin-haines-1
1247,Joseph Martinez,Michigan State,Big Ten,2,5,6,1.2,0,3.0,0,0,,0,0.0,5,6,1.2,0,,joseph-martinez-1
1248,JQ Gray,Southern Mississippi,Sun Belt,1,3,6,2.0,0,6.0,0,0,,0,0.0,3,6,2.0,0,,jq-gray-1
1249,Kody Epps,BYU,Big 12,8,3,6,2.0,0,0.8,21,259,12.3,0,32.4,24,265,11.0,0,,kody-epps-1
1250,Logan Point,Navy,American,6,2,6,3.0,0,1.0,0,0,,0,0.0,2,6,3.0,0,,logan-point-1
1251,Maurice Mazzccua,Nebraska,Big Ten,1,1,6,6.0,0,6.0,0,0,,0,0.0,1,6,6.0,0,,maurice-mazzccua-1
1252,Mavin Anderson*,California,Pac-12,9,1,6,6.0,0,0.7,8,87,10.9,0,9.7,9,93,10.3,0,,mavin-anderson-1
1253,Micah Kelly*,Toledo,MAC,4,5,6,1.2,0,1.5,1,5,5.0,0,1.3,6,11,1.8,0,,micah-kelly-1
1254,Sam Candotti*,Boston College,ACC,13,1,6,6.0,0,0.5,0,0,,0,0.0,1,6,6.0,0,,sam-candotti-1
1255,Shawn Harris Jr.,Massachusetts,Ind,11,2,6,3.0,0,0.5,16,152,9.5,0,13.8,18,158,8.8,0,,shawn-harris-jr-1
1256,Terry Lockett Jr.*,Eastern Michigan,MAC,7,1,6,6.0,0,0.9,3,34,11.3,0,4.9,4,40,10.0,0,,terry-lockett-jr-1
1257,Trimaine Brown Jr.*,Bowling Green,MAC,4,2,6,3.0,0,1.5,0,0,,0,0.0,2,6,3.0,0,,trimaine-brown-jr-1
1258,Will Pelissier*,Wyoming,MWC,9,3,6,2.0,0,0.7,7,79,11.3,1,8.8,10,85,8.5,1,,will-pelissier-1
1259,Zack Dobson,Middle Tennessee State,CUSA,10,4,6,1.5,1,0.6,21,305,14.5,2,30.5,25,311,12.4,3,,zack-dobson-2
1260,AJ Duffy*,Florida State,ACC,1,3,5,1.7,0,5.0,0,0,,0,0.0,3,5,1.7,0,,aj-duffy-1
1261,Anthony DiNota*,Texas A&M,SEC,1,2,5,2.5,0,5.0,0,0,,0,0.0,2,5,2.5,0,,anthony-dinota-1
1262,Brett Griffis*,James Madison,Sun Belt,1,2,5,2.5,0,5.0,0,0,,0,0.0,2,5,2.5,0,,brett-griffis-1
1263,Cannon Turner*,Air Force,MWC,2,3,5,1.7,0,2.5,0,0,,0,0.0,3,5,1.7,0,,cannon-turner-1
1264,Charles Kellom,Akron,MAC,12,4,5,1.3,0,0.4,0,0,,0,0.0,4,5,1.3,0,,charles-kellom-1
1265,Chris Edmonds*,Bowling Green,MAC,2,1,5,5.0,0,2.5,0,0,,0,0.0,1,5,5.0,0,,chris-edmonds-3
1266,Courtney Jackson*,Arkansas State,Sun Belt,13,1,5,5.0,0,0.4,39,689,17.7,7,53.0,40,694,17.4,7,,courtney-jackson-2
1267,Dante Wright,Temple,American,11,2,5,2.5,0,0.5,39,507,13.0,4,46.1,41,512,12.5,4,,dante-wright-1
1268,Darius Lassiter,BYU,Big 12,10,1,5,5.0,0,0.5,29,365,12.6,4,36.5,30,370,12.3,4,,darius-lassiter-1
1269,DC Tabscott,New Mexico,MWC,3,1,5,5.0,0,1.7,0,0,,0,0.0,1,5,5.0,0,,dc-tabscott-1
1270,Dylan Lonergan*,Alabama,SEC,1,1,5,5.0,0,5.0,0,0,,0,0.0,1,5,5.0,0,,dylan-lonergan-1
1271,Elijah Metcalf,Middle Tennessee State,CUSA,12,1,5,5.0,0,0.4,54,634,11.7,5,52.8,55,639,11.6,5,,elijah-metcalf-1
1272,Izayah Cummings*,Kentucky,SEC,12,1,5,5.0,0,0.4,4,98,24.5,0,8.2,5,103,20.6,0,,izayah-cummings-1
1273,Jalen Rogers*,Tulane,American,2,1,5,5.0,0,2.5,1,5,5.0,0,2.5,2,10,5.0,0,,jalen-rogers-2
1274,Jax Sherrard,Sam Houston,CUSA,10,1,5,5.0,0,0.5,12,147,12.3,1,14.7,13,152,11.7,1,,jax-sherrard-1
1275,Jayson Jones*,Jacksonville State,CUSA,7,1,5,5.0,0,0.7,2,24,12.0,0,3.4,3,29,9.7,0,,jayson-jones-3
1276,Jhaylin Embry*,Bowling Green,MAC,13,2,5,2.5,0,0.4,1,2,2.0,0,0.2,3,7,2.3,0,,jhaylin-embry-1
1277,JJ Branham*,Syracuse,ACC,1,3,5,1.7,0,5.0,0,0,,0,0.0,3,5,1.7,0,,jj-branham-1
1278,Joseph Daniels*,Georgia,SEC,1,2,5,2.5,0,5.0,0,0,,0,0.0,2,5,2.5,0,,joseph-daniels-1
1279,Josh Hoover,TCU,Big 12,10,20,5,0.3,2,0.5,0,0,,0,0.0,20,5,0.3,2,,josh-hoover-1
1280,Josiah Gonzales*,UCLA,Pac-12,2,3,5,1.7,0,2.5,0,0,,0,0.0,3,5,1.7,0,,josiah-gonzales-1
1281,Kyle Lowe,Middle Tennessee State,CUSA,2,3,5,1.7,0,2.5,0,0,,0,0.0,3,5,1.7,0,,kyle-lowe-2
1282,London Humphreys,Vanderbilt,SEC,12,1,5,5.0,0,0.4,22,439,20.0,4,36.6,23,444,19.3,4,,london-humphreys-1
1283,Louis Brown,Colorado State,MWC,12,3,5,1.7,0,0.4,47,481,10.2,5,40.1,50,486,9.7,5,,louis-brown-4
1284,Mareyohn Hrabowski,Western Michigan,MAC,3,2,5,2.5,0,1.7,0,0,,0,0.0,2,5,2.5,0,,mareyohn-hrabowski-1
1285,Oscar Cardenas*,UTSA,American,13,2,5,2.5,0,0.4,32,280,8.8,2,21.5,34,285,8.4,2,,oscar-cardenas-1
1286,Tae Meadows*,Troy,Sun Belt,1,1,5,5.0,1,5.0,0,0,,0,0.0,1,5,5.0,1,,tae-meadows-1
1287,Taven Curry,UAB,American,2,1,5,5.0,0,2.5,0,0,,0,0.0,1,5,5.0,0,,taven-curry-1
1288,Timothy Gans*,New Mexico State,CUSA,3,1,5,5.0,0,1.7,2,26,13.0,0,8.7,3,31,10.3,0,,timothy-gans-1
1289,Travis Glover*,Georgia State,Sun Belt,12,1,5,5.0,0,0.4,0,0,,0,0.0,1,5,5.0,0,,travis-glover-1
1290,Will Kacmarek*,Ohio,MAC,13,1,5,5.0,0,0.4,22,243,11.0,2,18.7,23,248,10.8,2,,will-kacmarek-1
1291,Aidan Swanson*,Clemson,ACC,13,1,4,4.0,0,0.3,0,0,,0,0.0,1,4,4.0,0,,aidan-swanson-1
1292,Alante Brown,Michigan State,Big Ten,11,10,4,0.4,0,0.4,3,27,9.0,0,2.5,13,31,2.4,0,,alante-brown-1
1293,Andy Alfieri*,California,Pac-12,1,2,4,2.0,0,4.0,0,0,,0,0.0,2,4,2.0,0,,andy-alfieri-1
1294,Anthony Switzer*,Utah State,MWC,12,1,4,4.0,0,0.3,0,0,,0,0.0,1,4,4.0,0,,anthony-switzer-1
1295,Billy Dozier*,Northern Illinois,MAC,13,4,4,1.0,0,0.3,6,66,11.0,0,5.1,10,70,7.0,0,,billy-dozier-1
1296,Christian Francisco*,Rice,American,8,1,4,4.0,1,0.5,0,0,,0,0.0,1,4,4.0,1,,christian-francisco-1
1297,C.J. Smith*,Georgia,SEC,10,1,4,4.0,0,0.4,6,116,19.3,0,11.6,7,120,17.1,0,,cj-smith-4
1298,Diante Vines*,Iowa,Big Ten,10,1,4,4.0,0,0.4,12,134,11.2,1,13.4,13,138,10.6,1,,diante-vines-1
1299,Dominic Gonnella*,South Florida,American,12,2,4,2.0,0,0.3,1,8,8.0,0,0.7,3,12,4.0,0,,dominic-gonnella-1
1300,Drae McCray*,Texas Tech,Big 12,13,1,4,4.0,0,0.3,29,255,8.8,2,19.6,30,259,8.6,2,,drae-mccray-1
1301,Franklin Estrada,TCU,Big 12,1,1,4,4.0,0,4.0,0,0,,0,0.0,1,4,4.0,0,,franklin-estrada-1
1302,Gaston Moore*,Tennessee,SEC,4,3,4,1.3,0,1.0,0,0,,0,0.0,3,4,1.3,0,,gaston-moore-1
1303,Harold Joiner,Michigan State,Big Ten,9,6,4,0.7,0,0.4,4,27,6.8,0,3.0,10,31,3.1,0,,harold-joiner-1
1304,Jaedon Wilson,Arkansas,SEC,12,1,4,4.0,0,0.3,15,199,13.3,2,16.6,16,203,12.7,2,,jaedon-wilson-1
1305,Jarel Williams*,West Virginia,Big 12,13,1,4,4.0,0,0.3,0,0,,0,0.0,1,4,4.0,0,,jarel-williams-1
1306,Jarvis Green*,Clemson,ACC,2,3,4,1.3,0,2.0,0,0,,0,0.0,3,4,1.3,0,,jarvis-green-2
1307,Jaylen Morgan,New Mexico,MWC,2,1,4,4.0,0,2.0,0,0,,0,0.0,1,4,4.0,0,,jaylen-morgan-2
1308,Kaleb Black,Arizona State,Pac-12,3,4,4,1.0,0,1.3,1,-2,-2.0,0,-0.7,5,2,0.4,0,,kaleb-black-1
1309,Landen King*,Utah,Pac-12,13,2,4,2.0,0,0.3,14,166,11.9,3,12.8,16,170,10.6,3,,landen-king-1
1310,Mikey Matthews*,Utah,Pac-12,12,1,4,4.0,0,0.3,29,261,9.0,0,21.8,30,265,8.8,0,,mikey-matthews-1
1311,Owen McGowan*,Boston College,ACC,13,1,4,4.0,0,0.3,2,11,5.5,1,0.8,3,15,5.0,1,,owen-mcgowan-1
1312,Parker Kingston,BYU,Big 12,12,6,4,0.7,0,0.3,19,207,10.9,1,17.3,25,211,8.4,1,,parker-kingston-1
1313,Robert Armes,Florida Atlantic,American,1,2,4,2.0,0,4.0,0,0,,0,0.0,2,4,2.0,0,,robert-armes-1
1314,Santino Marucci,Wake Forest,ACC,3,8,4,0.5,0,1.3,0,0,,0,0.0,8,4,0.5,0,,santino-marucci-1
1315,Shawqi Itraish*,Rice,American,3,1,4,4.0,0,1.3,0,0,,0,0.0,1,4,4.0,0,,shawqi-itraish-1
1316,Tanner Hughes*,Iowa State,Big 12,1,2,4,2.0,0,4.0,0,0,,0,0.0,2,4,2.0,0,,tanner-hughes-1
1317,Tyler Holzworth*,Penn State,Big Ten,2,3,4,1.3,0,2.0,0,0,,0,0.0,3,4,1.3,0,,tyler-holzworth-1
1318,Amari Johnson*,UCF,Big 12,3,2,3,1.5,0,1.0,0,0,,0,0.0,2,3,1.5,0,,amari-johnson-1
1319,Andrew Armstrong,Arkansas,SEC,12,1,3,3.0,0,0.3,56,764,13.6,5,63.7,57,767,13.5,5,,andrew-armstrong-2
1320,Behren Morton*,Texas Tech,Big 12,10,46,3,0.1,4,0.3,0,0,,0,0.0,46,3,0.1,4,,behren-morton-1
1321,Ben Easters*,Kansas,Big 12,1,1,3,3.0,0,3.0,0,0,,0,0.0,1,3,3.0,0,,ben-easters-1
1322,Brady Drogosh,Cincinnati,Big 12,1,3,3,1.0,0,3.0,0,0,,0,0.0,3,3,1.0,0,,brady-drogosh-1
1323,Brian Garcia,Louisiana-Monroe,Sun Belt,12,3,3,1.0,0,0.3,0,0,,0,0.0,3,3,1.0,0,,brian-garcia-1
1324,Charlie Mangieri*,Northwestern,Big Ten,12,1,3,3.0,0,0.3,7,53,7.6,1,4.4,8,56,7.0,1,,charlie-mangieri-1
1325,Chase Griffin*,UCLA,Pac-12,3,2,3,1.5,0,1.0,0,0,,0,0.0,2,3,1.5,0,,chase-griffin-1
1326,Devin Maddox*,Toledo,MAC,11,1,3,3.0,0,0.3,17,141,8.3,1,12.8,18,144,8.0,1,,devin-maddox-1
1327,Eric Rivers,Florida International,CUSA,11,1,3,3.0,0,0.3,32,370,11.6,2,33.6,33,373,11.3,2,,eric-rivers-2
1328,Ethan Rhodes*,North Carolina State,ACC,1,1,3,3.0,0,3.0,0,0,,0,0.0,1,3,3.0,0,,ethan-rhodes-1
1329,Evan Prater,Cincinnati,Big 12,11,2,3,1.5,0,0.3,12,114,9.5,0,10.4,14,117,8.4,0,,evan-prater-1
1330,Gino Campiotti,Massachusetts,Ind,12,1,3,3.0,0,0.3,21,289,13.8,4,24.1,22,292,13.3,4,,gino-campiotti-2
1331,Gunnar Greenwald*,South Florida,American,12,1,3,3.0,0,0.3,4,17,4.3,1,1.4,5,20,4.0,1,,gunnar-greenwald-1
1332,Henry Donohue*,Michigan,Big Ten,4,1,3,3.0,0,0.8,0,0,,0,0.0,1,3,3.0,0,,henry-donohue-1
1333,Ike Udengwu*,Eastern Michigan,MAC,4,6,3,0.5,0,0.8,0,0,,0,0.0,6,3,0.5,0,,ike-udengwu-1
1334,Isaiah Bond*,Alabama,SEC,14,1,3,3.0,0,0.2,48,668,13.9,4,47.7,49,671,13.7,4,,isaiah-bond-1
1335,Jaden Greathouse*,Notre Dame,Ind,12,1,3,3.0,0,0.3,18,265,14.7,5,22.1,19,268,14.1,5,,jaden-greathouse-1
1336,Jake Rendina,Army,Ind,3,1,3,3.0,0,1.0,0,0,,0,0.0,1,3,3.0,0,,jake-rendina-1
1337,Jalon Calhoun*,Duke,ACC,13,1,3,3.0,0,0.2,50,666,13.3,4,51.2,51,669,13.1,4,,jalon-calhoun-1
1338,Jayce Brown*,Kansas State,Big 12,10,4,3,0.8,0,0.3,27,437,16.2,3,43.7,31,440,14.2,3,,jayce-brown-1
1339,John Randle Jr.*,Utah,Pac-12,2,2,3,1.5,0,1.5,0,0,,0,0.0,2,3,1.5,0,,john-randle-jr-1
1340,Josh Kelly,Washington State,Pac-12,12,1,3,3.0,0,0.3,61,923,15.1,8,76.9,62,926,14.9,8,,josh-kelly-2
1341,Joshua Gray*,Oregon State,Pac-12,11,1,3,3.0,1,0.3,0,0,,0,0.0,1,3,3.0,1,,joshua-gray-1
1342,Kade Frew*,Air Force,MWC,3,1,3,3.0,0,1.0,0,0,,0,0.0,1,3,3.0,0,,kade-frew-1
1343,Ketron Jackson Jr.,Baylor,Big 12,10,1,3,3.0,0,0.3,28,489,17.5,1,48.9,29,492,17.0,1,,ketron-jackson-jr-1
1344,Kirk Francis,Tulsa,American,4,14,3,0.2,0,0.8,0,0,,0,0.0,14,3,0.2,0,,kirk-francis-1
1345,Kyle Thomas*,Northern Illinois,MAC,3,1,3,3.0,0,1.0,3,62,20.7,0,20.7,4,65,16.3,0,,kyle-thomas-2
1346,Marquis Johnson*,Missouri,SEC,13,1,3,3.0,0,0.2,13,383,29.5,3,29.5,14,386,27.6,3,,marquis-johnson-3
1347,Max White*,Iowa,Big Ten,14,3,3,1.0,1,0.2,0,0,,0,0.0,3,3,1.0,1,,max-white-1
1348,Mookie Cooper*,Missouri,SEC,13,1,3,3.0,0,0.2,36,447,12.4,0,34.4,37,450,12.2,0,,mookie-cooper-1
1349,Nash Jones*,Texas State,Sun Belt,5,1,3,3.0,1,0.6,0,0,,0,0.0,1,3,3.0,1,,nash-jones-1
1350,Nick Fedanzo,Illinois,Big Ten,5,1,3,3.0,0,0.6,0,0,,0,0.0,1,3,3.0,0,,nick-fedanzo-1
1351,Payton Wilson*,North Carolina State,ACC,12,1,3,3.0,0,0.3,0,0,,0,0.0,1,3,3.0,0,BednarikAA,payton-wilson-1
1352,Peyton Higgins*,Troy,Sun Belt,14,1,3,3.0,0,0.2,12,167,13.9,0,11.9,13,170,13.1,0,,peyton-higgins-1
1353,Pierce Clarkson*,Louisville,ACC,1,1,3,3.0,0,3.0,0,0,,0,0.0,1,3,3.0,0,,pierce-clarkson-1
1354,Preston Fox*,West Virginia,Big 12,12,1,3,3.0,0,0.3,26,368,14.2,2,30.7,27,371,13.7,2,,preston-fox-1
1355,Ramon Brown*,Maryland,Big Ten,1,1,3,3.0,0,3.0,0,0,,0,0.0,1,3,3.0,0,,ramon-brown-1
1356,Sam Assaf*,Notre Dame,Ind,2,2,3,1.5,0,1.5,0,0,,0,0.0,2,3,1.5,0,,sam-assaf-1
1357,Talik Keaton*,Marshall,Sun Belt,12,1,3,3.0,0,0.3,14,143,10.2,0,11.9,15,146,9.7,0,,talik-keaton-1
1358,Terrell Vaughn*,Utah State,MWC,13,4,3,0.8,0,0.2,89,933,10.5,11,71.8,93,936,10.1,11,,terrell-vaughn-1
1359,Tetairoa McMillan*,Arizona,Pac-12,13,1,3,3.0,0,0.2,90,1402,15.6,10,107.8,91,1405,15.4,10,,tetairoa-mcmillan-1
1360,Tevin Carter*,Memphis,American,6,3,3,1.0,0,0.5,0,0,,0,0.0,3,3,1.0,0,,tevin-carter-2
1361,Tralon Mitchell*,Virginia Tech,ACC,1,1,3,3.0,0,3.0,0,0,,0,0.0,1,3,3.0,0,,tralon-mitchell-1
1362,Wise Segars Jr.*,Clemson,ACC,1,1,3,3.0,0,3.0,0,0,,0,0.0,1,3,3.0,0,,wise-segars-jr-1
1363,Xavier White*,Texas Tech,Big 12,13,4,3,0.8,0,0.2,39,556,14.3,1,42.8,43,559,13.0,1,,xavier-white-1
1364,Anthony Evans III*,Georgia,SEC,8,1,2,2.0,0,0.3,4,35,8.8,1,4.4,5,37,7.4,1,,anthony-evans-iii-1
1365,Blake Bosma,Western Michigan,MAC,12,1,2,2.0,0,0.2,19,317,16.7,2,26.4,20,319,16.0,2,,blake-bosma-1
1366,Brant Ahlfinger,TCU,Big 12,8,1,2,2.0,0,0.3,0,0,,0,0.0,1,2,2.0,0,,brant-ahlfinger-1
1367,Brian Kowall*,UCLA,Pac-12,1,1,2,2.0,0,2.0,0,0,,0,0.0,1,2,2.0,0,,brian-kowall-1
1368,Bru McCoy*,Tennessee,SEC,5,1,2,2.0,0,0.4,17,217,12.8,1,43.4,18,219,12.2,1,,bru-mccoy-1
1369,Caleb Hampton,Stanford,Pac-12,3,1,2,2.0,0,0.7,0,0,,0,0.0,1,2,2.0,0,,caleb-hampton-1
1370,Casey Thompson,Florida Atlantic,American,3,10,2,0.2,0,0.7,0,0,,0,0.0,10,2,0.2,0,,casey-thompson-1
1371,Derrick Graham*,Troy,Sun Belt,14,1,2,2.0,1,0.1,0,0,,0,0.0,1,2,2.0,1,,derrick-graham-2
1372,Devonte Ross*,Troy,Sun Belt,14,1,2,2.0,0,0.1,40,428,10.7,3,30.6,41,430,10.5,3,,devonte-ross-2
1373,Dylan Rizk*,UCF,Big 12,1,2,2,1.0,0,2.0,0,0,,0,0.0,2,2,1.0,0,,dylan-rizk-1
1374,Grant Tisdale,TCU,Big 12,1,1,2,2.0,0,2.0,0,0,,0,0.0,1,2,2.0,0,,grant-tisdale-2
1375,Hal Presley,Baylor,Big 12,6,2,2,1.0,0,0.3,17,222,13.1,0,37.0,19,224,11.8,0,,hal-presley-1
1376,Hayden Timosciek*,Bowling Green,MAC,2,4,2,0.5,0,1.0,0,0,,0,0.0,4,2,0.5,0,,hayden-timosciek-1
1377,Jaheim Bell*,Florida State,ACC,13,4,2,0.5,1,0.2,39,503,12.9,2,38.7,43,505,11.7,3,,jaheim-bell-1
1378,Jerjuan Newton*,Toledo,MAC,14,1,2,2.0,0,0.1,52,696,13.4,9,49.7,53,698,13.2,9,,jerjuan-newton-1
1379,Jesse Mirco*,Ohio State,Big Ten,13,1,2,2.0,0,0.2,0,0,,0,0.0,1,2,2.0,0,,jesse-mirco-1
1380,Jhari Patterson,East Carolina,American,12,3,2,0.7,0,0.2,20,137,6.9,0,11.4,23,139,6.0,0,,jhari-patterson-1
1381,Johnathan Bennett*,Liberty,CUSA,5,1,2,2.0,0,0.4,0,0,,0,0.0,1,2,2.0,0,,johnathan-bennett-1
1382,Jonah Burton,Baylor,Big 12,10,2,2,1.0,0,0.2,9,110,12.2,0,11.0,11,112,10.2,0,,jonah-burton-1
1383,Jordan Anthony*,Texas A&M,SEC,4,1,2,2.0,0,0.5,3,14,4.7,0,3.5,4,16,4.0,0,,jordan-anthony-2
1384,Jordan Moore*,Duke,ACC,13,4,2,0.5,0,0.2,62,835,13.5,8,64.2,66,837,12.7,8,,jordan-moore-5
1385,Keon Coleman*,Florida State,ACC,12,1,2,2.0,0,0.2,50,658,13.2,11,54.8,51,660,12.9,11,,keon-coleman-1
1386,Khalil Crawford,Navy,American,11,2,2,1.0,0,0.2,0,0,,0,0.0,2,2,1.0,0,,khalil-crawford-1
1387,Lewis Bond*,Boston College,ACC,13,1,2,2.0,0,0.2,52,646,12.4,7,49.7,53,648,12.2,7,,lewis-bond-1
1388,Lincoln Kienholz*,Ohio State,Big Ten,3,6,2,0.3,0,0.7,0,0,,0,0.0,6,2,0.3,0,,lincoln-kienholz-1
1389,Matt Hayball,Vanderbilt,SEC,12,1,2,2.0,0,0.2,0,0,,0,0.0,1,2,2.0,0,,matt-hayball-1
1390,Mitchell Evans*,Notre Dame,Ind,8,1,2,2.0,0,0.3,29,422,14.6,1,52.8,30,424,14.1,1,,mitchell-evans-2
1391,Peter Montini,Colorado State,MWC,11,2,2,1.0,0,0.2,3,21,7.0,0,1.9,5,23,4.6,0,,peter-montini-1
1392,Roc Taylor*,Memphis,American,13,2,2,1.0,0,0.2,69,1083,15.7,4,83.3,71,1085,15.3,4,,roc-taylor-1
1393,Ryan Hilinski*,Northwestern,Big Ten,3,1,2,2.0,0,0.7,0,0,,0,0.0,1,2,2.0,0,,ryan-hilinski-1
1394,Tanner Knue*,Eastern Michigan,MAC,12,1,2,2.0,0,0.2,50,479,9.6,3,39.9,51,481,9.4,3,,tanner-knue-1
1395,Taylor Morin,Wake Forest,ACC,12,1,2,2.0,0,0.2,41,617,15.0,2,51.4,42,619,14.7,2,,taylor-morin-1
1396,Tobi Olawole,Army,Ind,10,3,2,0.7,0,0.2,7,101,14.4,0,10.1,10,103,10.3,0,,tobi-olawole-1
1397,Tonka Hemingway,South Carolina,SEC,12,1,2,2.0,1,0.2,0,0,,0,0.0,1,2,2.0,1,,tonka-hemingway-1
1398,Trace Bruckler,New Mexico,MWC,12,1,2,2.0,0,0.2,9,89,9.9,0,7.4,10,91,9.1,0,,trace-bruckler-1
1399,Adonai Mitchell*,Texas,Big 12,14,2,1,0.5,0,0.1,55,845,15.4,11,60.4,57,846,14.8,11,,adonai-mitchell-1
1400,Byron Murphy II*,Texas,Big 12,14,1,1,1.0,1,0.1,1,1,1.0,1,0.1,2,2,1.0,2,,byron-murphy-ii-1
1401,Cameron Friel*,Nevada-Las Vegas,MWC,1,1,1,1.0,1,1.0,0,0,,0,0.0,1,1,1.0,1,,cameron-friel-1
1402,Chris Lewis*,Troy,Sun Belt,14,1,1,1.0,0,0.1,32,735,23.0,10,52.5,33,736,22.3,10,,chris-lewis-7
1403,Cole Fuller*,Jacksonville State,CUSA,12,1,1,1.0,1,0.1,0,0,,0,0.0,1,1,1.0,1,,cole-fuller-1
1404,Daejon Reynolds,Pitt,ACC,12,1,1,1.0,0,0.1,28,316,11.3,0,26.3,29,317,10.9,0,,daejon-reynolds-1
1405,Dallin Holker,Colorado State,MWC,12,1,1,1.0,1,0.1,64,767,12.0,6,63.9,65,768,11.8,7,,dallin-holker-1
1406,Dean Patterson,Florida International,CUSA,12,1,1,1.0,0,0.1,28,423,15.1,1,35.3,29,424,14.6,1,,dean-patterson-1
1407,DeAndra Burns Jr.*,Arkansas State,Sun Belt,12,1,1,1.0,0,0.1,0,0,,0,0.0,1,1,1.0,0,,deandra-burns-jr-1
1408,Dequece Carter,Indiana,Big Ten,12,1,1,1.0,0,0.1,27,395,14.6,3,32.9,28,396,14.1,3,,dequece-carter-1
1409,Dijon Stanley*,Utah,Pac-12,10,6,1,0.2,0,0.1,3,21,7.0,0,2.1,9,22,2.4,0,,dijon-stanley-1
1410,DJ Lundy*,Florida State,ACC,13,1,1,1.0,1,0.1,0,0,,0,0.0,1,1,1.0,1,,dj-lundy-1
1411,Elijah Sarratt*,James Madison,Sun Belt,13,1,1,1.0,1,0.1,82,1191,14.5,8,91.6,83,1192,14.4,9,,elijah-sarratt-1
1412,Enoch Nawahine,BYU,Big 12,11,1,1,1.0,0,0.1,0,0,,0,0.0,1,1,1.0,0,,enoch-nawahine-2
1413,Garrett Nussmeier*,LSU,SEC,7,1,1,1.0,1,0.1,0,0,,0,0.0,1,1,1.0,1,,garrett-nussmeier-1
1414,Hamp Greene*,Clemson,ACC,11,1,1,1.0,0,0.1,2,17,8.5,0,1.5,3,18,6.0,0,,hamp-greene-3
1415,Harold Perkins*,LSU,SEC,13,1,1,1.0,1,0.1,0,0,,0,0.0,1,1,1.0,1,,harold-perkins-1
1416,Jack Westover*,Washington,Pac-12,15,1,1,1.0,1,0.1,46,433,9.4,4,28.9,47,434,9.2,5,,jack-westover-1
1417,Jaelon Barbarin,Michigan State,Big Ten,1,1,1,1.0,0,1.0,0,0,,0,0.0,1,1,1.0,0,,jaelon-barbarin-1
1418,Jake Jensen*,USC,Pac-12,1,1,1,1.0,0,1.0,0,0,,0,0.0,1,1,1.0,0,,jake-jensen-1
1419,Jarod Bowie*,Jacksonville State,CUSA,3,1,1,1.0,0,0.3,0,0,,0,0.0,1,1,1.0,0,,jarod-bowie-1
1420,JB Mitchell III*,Eastern Michigan,MAC,12,1,1,1.0,0,0.1,35,398,11.4,1,33.2,36,399,11.1,1,,jb-mitchell-iii-1
1421,Joe Jackson*,Kansas State,Big 12,2,4,1,0.3,0,0.5,0,0,,0,0.0,4,1,0.3,0,,joe-jackson-4
1422,Josh Cameron,Baylor,Big 12,12,2,1,0.5,0,0.1,21,224,10.7,0,18.7,23,225,9.8,0,,josh-cameron-1
1423,Kaedin Robinson*,Appalachian State,Sun Belt,14,1,1,1.0,0,0.1,67,905,13.5,10,64.6,68,906,13.3,10,,kaedin-robinson-1
1424,Kellen Stewart,Middle Tennessee State,CUSA,9,1,1,1.0,0,0.1,3,17,5.7,0,1.9,4,18,4.5,0,,kellen-stewart-1
1425,Luke MacPhail*,Syracuse,ACC,3,1,1,1.0,0,0.3,0,0,,0,0.0,1,1,1.0,0,,luke-macphail-1
1426,Malachi Lane*,LSU,SEC,5,1,1,1.0,0,0.2,0,0,,0,0.0,1,1,1.0,0,,malachi-lane-1
1427,Malik Nabers*,LSU,SEC,13,1,1,1.0,0,0.1,89,1569,17.6,14,120.7,90,1570,17.4,14,AA,malik-nabers-1
1428,Mark Nabou*,Texas A&M,SEC,12,1,1,1.0,1,0.1,0,0,,0,0.0,1,1,1.0,1,,mark-nabou-1
1429,Marlion Jackson,Louisiana Tech,CUSA,10,2,1,0.5,0,0.1,12,161,13.4,0,16.1,14,162,11.6,0,,marlion-jackson-1
1430,Marshawn Kneeland,Western Michigan,MAC,10,2,1,0.5,1,0.1,0,0,,0,0.0,2,1,0.5,1,,marshawn-kneeland-1
1431,Nate Hampton*,Liberty,CUSA,2,2,1,0.5,0,0.5,0,0,,0,0.0,2,1,0.5,0,,nate-hampton-1
1432,Ricky White*,Nevada-Las Vegas,MWC,14,1,1,1.0,0,0.1,88,1483,16.9,8,105.9,89,1484,16.7,8,,ricky-white-2
1433,Sam Roush,Stanford,Pac-12,12,1,1,1.0,0,0.1,28,288,10.3,0,24.0,29,289,10.0,0,,sam-roush-1
1434,Sam Wiglusz*,Ohio,MAC,12,1,1,1.0,0,0.1,56,660,11.8,3,55.0,57,661,11.6,3,,sam-wiglusz-1
1435,Smoke Harris,Louisiana Tech,CUSA,12,9,1,0.1,0,0.1,83,796,9.6,4,66.3,92,797,8.7,4,,smoke-harris-1
1436,Tadd Barr,Buffalo,MAC,12,1,1,1.0,0,0.1,0,0,,0,0.0,1,1,1.0,0,,tadd-barr-1
1437,Taj Davis*,California,Pac-12,11,1,1,1.0,0,0.1,39,399,10.2,3,36.3,40,400,10.0,3,,taj-davis-1
1438,Tre Bradford*,LSU,SEC,1,4,1,0.3,1,1.0,1,55,55.0,0,55.0,5,56,11.2,1,,tre-bradford-1
1439,Tyler Jefferson,Central Michigan,MAC,2,1,1,1.0,0,0.5,0,0,,0,0.0,1,1,1.0,0,,tyler-jefferson-1
1440,Zak Burnett*,Liberty,CUSA,2,1,1,1.0,0,0.5,0,0,,0,0.0,1,1,1.0,0,,zak-burnett-1
1441,Ahmarean Brown,South Carolina,SEC,9,2,0,0.0,0,0.0,26,265,10.2,1,29.4,28,265,9.5,1,,ahmarean-brown-1
1442,Al-Jay Henderson,Buffalo,MAC,10,5,0,0.0,1,0.0,0,0,,0,0.0,5,0,0.0,1,,al-jay-henderson-1
1443,Anthony Sambucci,Western Michigan,MAC,9,2,0,0.0,0,0.0,21,318,15.1,5,35.3,23,318,13.8,5,,anthony-sambucci-1
1444,Braden Smith,Cincinnati,Big 12,12,2,0,0.0,0,0.0,43,557,13.0,4,46.4,45,557,12.4,4,,braden-smith-4
1445,Chase Penry*,Boise State,MWC,4,1,0,0.0,0,0.0,5,48,9.6,0,12.0,6,48,8.0,0,,chase-penry-1
1446,Devan Williams,Tulsa,American,9,1,0,0.0,0,0.0,29,399,13.8,2,44.3,30,399,13.3,2,,devan-williams-1
1447,DJ Twitty,South Carolina,SEC,3,3,0,0.0,0,0.0,0,0,,0,0.0,3,0,0.0,0,,dj-twitty-1
1448,Dominick Mazotti*,San Jose State,MWC,11,1,0,0.0,0,0.0,23,322,14.0,2,29.3,24,322,13.4,2,,dominick-mazotti-1
1449,Gavin Yates,Baylor,Big 12,9,1,0,0.0,0,0.0,2,10,5.0,0,1.1,3,10,3.3,0,,gavin-yates-1
1450,Isaac TeSlaa,Arkansas,SEC,12,1,0,0.0,0,0.0,34,351,10.3,2,29.3,35,351,10.0,2,,isaac-teslaa-1
1451,Isaiah Carlson*,UCLA,Pac-12,1,1,0,0.0,0,0.0,0,0,,0,0.0,1,0,0.0,0,,isaiah-carlson-1
1452,Jack Browning,San Diego State,MWC,12,1,0,0.0,0,0.0,1,-2,-2.0,0,-0.2,2,-2,-1.0,0,,jack-browning-1
1453,Jordan Louie*,North Carolina,ACC,1,1,0,0.0,0,0.0,0,0,,0,0.0,1,0,0.0,0,,jordan-louie-1
1454,Josiah Johnson*,Oklahoma State,Big 12,14,1,0,0.0,0,0.0,22,166,7.5,1,11.9,23,166,7.2,1,,josiah-johnson-1
1455,Justin Holaday,New Mexico,MWC,4,1,0,0.0,0,0.0,0,0,,0,0.0,1,0,0.0,0,,justin-holaday-1
1456,KD Dorsey*,Georgia Southern,Sun Belt,8,1,0,0.0,0,0.0,5,31,6.2,0,3.9,6,31,5.2,0,,kd-dorsey-1
1457,Keandre Lambert-Smith*,Penn State,Big Ten,13,2,0,0.0,0,0.0,53,673,12.7,4,51.8,55,673,12.2,4,,keandre-lambert-smith-1
1458,Kelby Williams*,Old Dominion,Sun Belt,12,1,0,0.0,0,0.0,26,451,17.3,2,37.6,27,451,16.7,2,,kelby-williams-1
1459,Kendin Alexander*,Air Force,MWC,3,1,0,0.0,0,0.0,0,0,,0,0.0,1,0,0.0,0,,kendin-alexander-1
1460,Kevin McNeal*,Clemson,ACC,2,1,0,0.0,0,0.0,0,0,,0,0.0,1,0,0.0,0,,kevin-mcneal-1
1461,Kris Mitchell,Florida International,CUSA,12,1,0,0.0,0,0.0,64,1118,17.5,6,93.2,65,1118,17.2,6,,kris-mitchell-1
1462,Kuao Peihopa,Hawaii,MWC,13,1,0,0.0,0,0.0,0,0,,0,0.0,1,0,0.0,0,,kuao-peihopa-1
1463,Luke Doty,South Carolina,SEC,12,2,0,0.0,1,0.0,13,123,9.5,1,10.3,15,123,8.2,2,,luke-doty-1
1464,Marcus Bellon,UTEP,CUSA,4,1,0,0.0,0,0.0,10,97,9.7,0,24.3,11,97,8.8,0,,marcus-bellon-1
1465,Marcus Vinson,UTEP,CUSA,12,1,0,0.0,0,0.0,3,40,13.3,1,3.3,4,40,10.0,1,,marcus-vinson-1
1466,Mario Agyen*,Louisville,ACC,1,1,0,0.0,0,0.0,0,0,,0,0.0,1,0,0.0,0,,mario-agyen-1
1467,Mario Williams*,USC,Pac-12,12,2,0,0.0,0,0.0,29,305,10.5,2,25.4,31,305,9.8,2,,mario-williams-2
1468,Minaya Olivo*,UCLA,Pac-12,1,1,0,0.0,0,0.0,0,0,,0,0.0,1,0,0.0,0,,minaya-olivo-1
1469,Nick Gardinera,San Diego State,MWC,7,1,0,0.0,0,0.0,0,0,,0,0.0,1,0,0.0,0,,nick-gardinera-1
1470,Nick Nash*,San Jose State,MWC,13,1,0,0.0,0,0.0,48,728,15.2,8,56.0,49,728,14.9,8,,nick-nash-1
1471,Solomon Lewis,Louisiana Tech,CUSA,5,1,0,0.0,0,0.0,2,56,28.0,0,11.2,3,56,18.7,0,,solomon-lewis-1
1472,Willie McCoy*,UTSA,American,10,3,0,0.0,0,0.0,18,164,9.1,2,16.4,21,164,7.8,2,,willie-mccoy-1
1473,Xavier Guillory,Arizona State,Pac-12,9,1,0,0.0,0,0.0,21,226,10.8,1,25.1,22,226,10.3,1,,xavier-guillory-1
1474,Caleb Merritt*,Wyoming,MWC,6,1,-1,-1.0,0,-0.2,1,7,7.0,0,1.2,2,6,3.0,0,,caleb-merritt-1
1475,Charles Schibler*,Tulane,American,1,1,-1,-1.0,0,-1.0,0,0,,0,0.0,1,-1,-1.0,0,,charles-schibler-1
1476,Chris Tyree*,Notre Dame,Ind,12,3,-1,-0.3,0,-0.1,26,484,18.6,3,40.3,29,483,16.7,3,,chris-tyree-1
1477,Coy Eakin*,Texas Tech,Big 12,10,1,-1,-1.0,0,-0.1,36,416,11.6,2,41.6,37,415,11.2,2,,coy-eakin-1
1478,Dalevon Campbell,Nevada,MWC,12,1,-1,-1.0,0,-0.1,31,594,19.2,2,49.5,32,593,18.5,2,,dalevon-campbell-1
1479,Donaven McCulley,Indiana,Big Ten,12,3,-1,-0.3,0,-0.1,48,644,13.4,6,53.7,51,643,12.6,6,,donaven-mcculley-1
1480,Evan Bullock,Louisiana Tech,CUSA,1,1,-1,-1.0,0,-1.0,0,0,,0,0.0,1,-1,-1.0,0,,evan-bullock-1
1481,Giovanni Sanders,Arizona State,Pac-12,12,2,-1,-0.5,0,-0.1,15,133,8.9,0,11.1,17,132,7.8,0,,giovanni-sanders-1
1482,Griffin Moore,Illinois,Big Ten,12,1,-1,-1.0,0,-0.1,12,161,13.4,1,13.4,13,160,12.3,1,,griffin-moore-1
1483,Jamal Roberts*,Missouri,SEC,2,1,-1,-1.0,0,-0.5,0,0,,0,0.0,1,-1,-1.0,0,,jamal-roberts-2
1484,Jaylin Noel*,Iowa State,Big 12,12,1,-1,-1.0,0,-0.1,66,820,12.4,7,68.3,67,819,12.2,7,,jaylin-noel-1
1485,Jeshaun Jones*,Maryland,Big Ten,13,1,-1,-1.0,0,-0.1,56,790,14.1,4,60.8,57,789,13.8,4,,jeshaun-jones-1
1486,Joey Hobert*,Texas State,Sun Belt,11,1,-1,-1.0,0,-0.1,76,895,11.8,8,81.4,77,894,11.6,8,,joey-hobert-1
1487,Jordan Yates,Sam Houston,CUSA,10,2,-1,-0.5,0,-0.1,1,13,13.0,0,1.3,3,12,4.0,0,,jordan-yates-1
1488,Kelvontay Dixon*,SMU,American,13,1,-1,-1.0,0,-0.1,25,441,17.6,4,33.9,26,440,16.9,4,,kelvontay-dixon-1
1489,Keynan Higgins*,San Jose State,MWC,10,1,-1,-1.0,0,-0.1,0,0,,0,0.0,1,-1,-1.0,0,,keynan-higgins-1
1490,Kyre Duplessis*,Coastal Carolina,Sun Belt,13,1,-1,-1.0,0,-0.1,16,242,15.1,1,18.6,17,241,14.2,1,,kyre-duplessis-1
1491,Mike Jackson,Florida International,CUSA,6,2,-1,-0.5,0,-0.2,0,0,,0,0.0,2,-1,-0.5,0,,mike-jackson-5
1492,Octavian Smith Jr.*,Maryland,Big Ten,13,2,-1,-0.5,0,-0.1,22,209,9.5,1,16.1,24,208,8.7,1,,octavian-smith-jr-1
1493,Sam Horn*,Missouri,SEC,3,3,-1,-0.3,0,-0.3,0,0,,0,0.0,3,-1,-0.3,0,,sam-horn-1
1494,Tailique Williams*,Georgia State,Sun Belt,13,1,-1,-1.0,0,-0.1,49,615,12.6,6,47.3,50,614,12.3,6,,tailique-williams-1
1495,Terry Berdin Jr.*,Georgia State,Sun Belt,13,1,-1,-1.0,0,-0.1,0,0,,0,0.0,1,-1,-1.0,0,,terry-berdin-jr-1
1496,Yamir Knight*,James Madison,Sun Belt,11,1,-1,-1.0,0,-0.1,8,73,9.1,0,6.6,9,72,8.0,0,,yamir-knight-1
1497,Addai Lewellen,Purdue,Big Ten,1,1,-2,-2.0,0,-2.0,0,0,,0,0.0,1,-2,-2.0,0,,addai-lewellen-1
1498,Ashtyn Hawkins*,Texas State,Sun Belt,13,1,-2,-2.0,0,-0.2,55,874,15.9,3,67.2,56,872,15.6,3,,ashtyn-hawkins-1
1499,Braedyn Locke*,Wisconsin,Big Ten,5,17,-2,-0.1,0,-0.4,0,0,,0,0.0,17,-2,-0.1,0,,braedyn-locke-1
1500,Christian Leary*,Georgia Tech,ACC,13,2,-2,-1.0,0,-0.2,25,309,12.4,2,23.8,27,307,11.4,2,,christian-leary-1
1501,Isaiah Helms*,Appalachian State,Sun Belt,14,2,-2,-1.0,0,-0.1,0,0,,0,0.0,2,-2,-1.0,0,,isaiah-helms-1
1502,Jaden Alexis*,South Florida,American,13,1,-2,-2.0,0,-0.2,23,280,12.2,2,21.5,24,278,11.6,2,,jaden-alexis-1
1503,Jay Butterfield*,San Jose State,MWC,4,2,-2,-1.0,0,-0.5,0,0,,0,0.0,2,-2,-1.0,0,,jay-butterfield-1
1504,Jayden Clemons*,Wyoming,MWC,2,1,-2,-2.0,0,-1.0,0,0,,0,0.0,1,-2,-2.0,0,,jayden-clemons-1
1505,Jaylon Robinson,TCU,Big 12,10,2,-2,-1.0,0,-0.2,32,397,12.4,1,39.7,34,395,11.6,1,,jaylon-robinson-1
1506,Kavosiey Smoke,Colorado,Pac-12,10,2,-2,-1.0,0,-0.2,0,0,,0,0.0,2,-2,-1.0,0,,kavosiey-smoke-1
1507,Luke Lindenmeyer,Nebraska,Big Ten,12,1,-2,-2.0,0,-0.2,0,0,,0,0.0,1,-2,-2.0,0,,luke-lindenmeyer-1
1508,Mekhi Mews*,Georgia,SEC,13,1,-2,-2.0,0,-0.2,13,155,11.9,1,11.9,14,153,10.9,1,,mekhi-mews-1
1509,Mycah Pittman*,Utah,Pac-12,2,1,-2,-2.0,0,-1.0,3,20,6.7,0,10.0,4,18,4.5,0,,mycah-pittman-1
1510,Ray Paulo,BYU,Big 12,10,1,-2,-2.0,0,-0.2,1,-1,-1.0,0,-0.1,2,-3,-1.5,0,,ray-paulo-1
1511,Yamil Oaxaca,UTEP,CUSA,6,1,-2,-2.0,0,-0.3,0,0,,0,0.0,1,-2,-2.0,0,,yamil-oaxaca-1
1512,Cody Simon*,Ohio State,Big Ten,13,1,-3,-3.0,0,-0.2,0,0,,0,0.0,1,-3,-3.0,0,,cody-simon-1
1513,Donovan Brown*,Syracuse,ACC,13,1,-3,-3.0,0,-0.2,27,321,11.9,1,24.7,28,318,11.4,1,,donovan-brown-1
1514,DT Sheffield,Washington State,Pac-12,2,1,-3,-3.0,0,-1.5,4,26,6.5,0,13.0,5,23,4.6,0,,dt-sheffield-1
1515,Evan Stewart*,Texas A&M,SEC,8,1,-3,-3.0,0,-0.4,38,514,13.5,4,64.3,39,511,13.1,4,,evan-stewart-2
1516,Gavin Kuld,Colorado,Pac-12,2,3,-3,-1.0,0,-1.5,0,0,,0,0.0,3,-3,-1.0,0,,gavin-kuld-1
1517,Jack Bech,TCU,Big 12,8,3,-3,-1.0,0,-0.4,12,146,12.2,0,18.3,15,143,9.5,0,,jack-bech-1
1518,Jalen Knox*,Ole Miss,SEC,12,1,-3,-3.0,0,-0.3,1,9,9.0,0,0.8,2,6,3.0,0,,jalen-knox-2
1519,Joey Gatewood*,Louisville,ACC,12,1,-3,-3.0,0,-0.3,9,150,16.7,3,12.5,10,147,14.7,3,,joey-gatewood-1
1520,Joseph Manjack IV,Houston,Big 12,10,2,-3,-1.5,0,-0.3,46,577,12.5,6,57.7,48,574,12.0,6,,joseph-manjack-iv-1
1521,Nathan Harris-Waynick,South Carolina,SEC,1,1,-3,-3.0,0,-3.0,0,0,,0,0.0,1,-3,-3.0,0,,nathan-harris-waynick-1
1522,Blake Murphy,Louisiana-Monroe,Sun Belt,4,22,-4,-0.2,0,-1.0,0,0,,0,0.0,22,-4,-0.2,0,,blake-murphy-2
1523,Brady Hodges*,Louisville,ACC,14,1,-4,-4.0,0,-0.3,0,0,,0,0.0,1,-4,-4.0,0,,brady-hodges-1
1524,Chris Culliver*,North Carolina,ACC,11,1,-4,-4.0,0,-0.4,1,41,41.0,1,3.7,2,37,18.5,1,,chris-culliver-2
1525,Christian Wells,Massachusetts,Ind,11,2,-4,-2.0,0,-0.4,11,169,15.4,1,15.4,13,165,12.7,1,,christian-wells-1
1526,Corey Stewart,Ball State,MAC,12,1,-4,-4.0,0,-0.3,0,0,,0,0.0,1,-4,-4.0,0,,corey-stewart-1
1527,Davis Warren*,Michigan,Big Ten,3,2,-4,-2.0,0,-1.3,0,0,,0,0.0,2,-4,-2.0,0,,davis-warren-1
1528,Grant Gunnell,Sam Houston,CUSA,1,4,-4,-1.0,0,-4.0,0,0,,0,0.0,4,-4,-1.0,0,,grant-gunnell-1
1529,Jovoni Johnson*,Rice,American,8,1,-4,-4.0,0,-0.5,3,54,18.0,0,6.8,4,50,12.5,0,,jovoni-johnson-1
1530,Maddox Kopp*,Miami (OH),MAC,2,1,-4,-4.0,0,-2.0,0,0,,0,0.0,1,-4,-4.0,0,,maddox-kopp-2
1531,Max Reese*,Eastern Michigan,MAC,8,1,-4,-4.0,0,-0.5,2,8,4.0,0,1.0,3,4,1.3,0,,max-reese-1
1532,Nico Ragaini*,Iowa,Big Ten,14,3,-4,-1.3,0,-0.3,31,255,8.2,0,18.2,34,251,7.4,0,,nico-ragaini-1
1533,Will Crowder*,Troy,Sun Belt,14,6,-4,-0.7,0,-0.3,0,0,,0,0.0,6,-4,-0.7,0,,will-crowder-1
1534,Bryce Archie*,South Florida,American,7,9,-5,-0.6,0,-0.7,0,0,,0,0.0,9,-5,-0.6,0,,bryce-archie-1
1535,Cade Fennegan,BYU,Big 12,1,2,-5,-2.5,0,-5.0,0,0,,0,0.0,2,-5,-2.5,0,,cade-fennegan-1
1536,Daniel Jackson*,Minnesota,Big Ten,13,1,-5,-5.0,0,-0.4,59,831,14.1,8,63.9,60,826,13.8,8,,daniel-jackson-5
1537,Dylan Morris*,Washington,Pac-12,4,1,-5,-5.0,0,-1.3,0,0,,0,0.0,1,-5,-5.0,0,,dylan-morris-1
1538,Jacob Conover,Arizona State,Pac-12,3,10,-5,-0.5,0,-1.7,0,0,,0,0.0,10,-5,-0.5,0,,jacob-conover-1
1539,Jaden Bray*,Oklahoma State,Big 12,10,1,-5,-5.0,0,-0.5,30,382,12.7,2,38.2,31,377,12.2,2,,jaden-bray-1
1540,Justin Ball,Vanderbilt,SEC,12,1,-5,-5.0,0,-0.4,15,131,8.7,1,10.9,16,126,7.9,1,,justin-ball-1
1541,Kaiya Sheron*,Kentucky,SEC,5,2,-5,-2.5,0,-1.0,0,0,,0,0.0,2,-5,-2.5,0,,kaiya-sheron-1
1542,Ryan Rehkow,BYU,Big 12,12,1,-5,-5.0,0,-0.4,0,0,,0,0.0,1,-5,-5.0,0,,ryan-rehkow-1
1543,Tom Foley*,Northern Illinois,MAC,13,1,-5,-5.0,0,-0.4,0,0,,0,0.0,1,-5,-5.0,0,,tom-foley-1
1544,Tommi Hill,Nebraska,Big Ten,12,1,-5,-5.0,0,-0.4,0,0,,0,0.0,1,-5,-5.0,0,,tommi-hill-1
1545,Zach Mundell,Army,Ind,6,4,-5,-1.3,0,-0.8,2,13,6.5,0,2.2,6,8,1.3,0,,zach-mundell-1
1546,Amad Anderson Jr.,Temple,American,11,2,-6,-3.0,0,-0.5,37,647,17.5,3,58.8,39,641,16.4,3,,amad-anderson-jr-1
1547,Ben Kopenski,Tulsa,American,12,1,-6,-6.0,0,-0.5,0,0,,0,0.0,1,-6,-6.0,0,,ben-kopenski-1
1548,Brett Buckman,Connecticut,Ind,12,2,-6,-3.0,0,-0.5,46,488,10.6,2,40.7,48,482,10.0,2,,brett-buckman-1
1549,Brian Thomas Jr.*,LSU,SEC,13,1,-6,-6.0,0,-0.5,68,1177,17.3,17,90.5,69,1171,17.0,17,,brian-thomas-jr-1
1550,Kamryn Perry,Indiana,Big Ten,9,2,-6,-3.0,0,-0.7,3,22,7.3,0,2.4,5,16,3.2,0,,kamryn-perry-1
1551,Luke Grimm*,Kansas,Big 12,13,1,-6,-6.0,0,-0.5,33,555,16.8,6,42.7,34,549,16.1,6,,luke-grimm-1
1552,Malachi Fields,Virginia,ACC,12,1,-6,-6.0,0,-0.5,58,811,14.0,5,67.6,59,805,13.6,5,,malachi-fields-1
1553,Tyler Davis*,Clemson,ACC,13,1,-6,-6.0,0,-0.5,0,0,,0,0.0,1,-6,-6.0,0,,tyler-davis-4
1554,Tyriq Starks,Florida Atlantic,American,1,4,-6,-1.5,0,-6.0,0,0,,0,0.0,4,-6,-1.5,0,,tyriq-starks-1
1555,Andrew Schorfhaar,Michigan State,Big Ten,2,1,-7,-7.0,0,-3.5,0,0,,0,0.0,1,-7,-7.0,0,,andrew-schorfhaar-2
1556,Israel Carter*,South Florida,American,3,2,-7,-3.5,0,-2.3,1,7,7.0,0,2.3,3,0,0.0,0,,israel-carter-1
1557,James Burns,Connecticut,Ind,6,1,-7,-7.0,0,-1.2,2,21,10.5,0,3.5,3,14,4.7,0,,james-burns-2
1558,John Bock II,Florida International,CUSA,8,1,-7,-7.0,0,-0.9,0,0,,0,0.0,1,-7,-7.0,0,,john-bock-ii-1
1559,Kole Wilson*,Texas State,Sun Belt,13,2,-7,-3.5,0,-0.5,66,747,11.3,8,57.5,68,740,10.9,8,,kole-wilson-1
1560,Tanner Bailey,South Carolina,SEC,1,1,-7,-7.0,0,-7.0,0,0,,0,0.0,1,-7,-7.0,0,,tanner-bailey-1
1561,CJ Tiller*,Boise State,MWC,2,3,-8,-2.7,0,-4.0,0,0,,0,0.0,3,-8,-2.7,0,,cj-tiller-1
1562,Clay Millen,Colorado State,MWC,1,2,-8,-4.0,0,-8.0,0,0,,0,0.0,2,-8,-4.0,0,,clay-millen-1
1563,Cyrus Allen,Louisiana Tech,CUSA,11,2,-8,-4.0,0,-0.7,46,778,16.9,4,70.7,48,770,16.0,4,,cyrus-allen-1
1564,Darion Williamson*,Florida State,ACC,12,2,-8,-4.0,0,-0.7,9,127,14.1,1,10.6,11,119,10.8,1,,darion-williamson-1
1565,Demarcus Jones*,North Carolina State,ACC,8,5,-8,-1.6,1,-1.0,1,17,17.0,0,2.1,6,9,1.5,1,,demarcus-jones-1
1566,Gavin Hardison,UTEP,CUSA,5,34,-8,-0.2,2,-1.6,0,0,,0,0.0,34,-8,-0.2,2,,gavin-hardison-1
1567,Isiah Paige*,Old Dominion,Sun Belt,11,1,-8,-8.0,0,-0.7,43,445,10.3,2,40.5,44,437,9.9,2,,isiah-paige-1
1568,Jacari Carter*,Georgia State,Sun Belt,13,1,-8,-8.0,0,-0.6,38,276,7.3,0,21.2,39,268,6.9,0,,jacari-carter-1
1569,Jarius Mack,Charlotte,American,11,2,-8,-4.0,0,-0.7,25,453,18.1,2,41.2,27,445,16.5,2,,jarius-mack-1
1570,Joey Cheek*,Utah,Pac-12,3,1,-8,-8.0,0,-2.7,0,0,,0,0.0,1,-8,-8.0,0,,joey-cheek-1
1571,Jordy Sandy,TCU,Big 12,12,1,-8,-8.0,0,-0.7,0,0,,0,0.0,1,-8,-8.0,0,,jordy-sandy-1
1572,Kobe Hudson*,UCF,Big 12,13,1,-8,-8.0,0,-0.6,44,900,20.5,8,69.2,45,892,19.8,8,,kobe-hudson-1
1573,Roman Fuller,Tulsa,American,4,2,-8,-4.0,0,-2.0,0,0,,0,0.0,2,-8,-4.0,0,,roman-fuller-1
1574,Sean Wilson,Virginia,ACC,12,1,-8,-8.0,0,-0.7,10,98,9.8,0,8.2,11,90,8.2,0,,sean-wilson-4
1575,Brady Denaburg*,Syracuse,ACC,13,1,-9,-9.0,0,-0.7,0,0,,0,0.0,1,-9,-9.0,0,,brady-denaburg-1
1576,Bronson Barron*,Western Kentucky,CUSA,2,1,-9,-9.0,0,-4.5,1,-3,-3.0,0,-1.5,2,-12,-6.0,0,,bronson-barron-1
1577,Chris Parson,Mississippi State,SEC,2,9,-9,-1.0,0,-4.5,0,0,,0,0.0,9,-9,-1.0,0,,chris-parson-1
1578,Gavin Meyers*,Wisconsin,Big Ten,13,1,-9,-9.0,0,-0.7,0,0,,0,0.0,1,-9,-9.0,0,,gavin-meyers-1
1579,Jordan Watkins*,Ole Miss,SEC,13,1,-9,-9.0,0,-0.7,53,741,14.0,3,57.0,54,732,13.6,3,,jordan-watkins-2
1580,Joshua Cephus*,UTSA,American,13,1,-9,-9.0,0,-0.7,89,1151,12.9,10,88.5,90,1142,12.7,10,,joshua-cephus-1
1581,Stephan Bracey,Central Michigan,MAC,11,1,-9,-9.0,0,-0.8,10,66,6.6,0,6.0,11,57,5.2,0,,stephan-bracey-1
1582,Xavier Legette,South Carolina,SEC,12,9,-9,-1.0,0,-0.8,71,1255,17.7,7,104.6,80,1246,15.6,7,,xavier-legette-1
1583,Braden Davis*,Syracuse,ACC,3,6,-10,-1.7,0,-3.3,2,6,3.0,0,2.0,8,-4,-0.5,0,,braden-davis-1
1584,Kyle Williams,Washington State,Pac-12,12,3,-10,-3.3,0,-0.8,61,843,13.8,6,70.3,64,833,13.0,6,,kyle-williams-11
1585,Ryan Burger*,Appalachian State,Sun Belt,1,4,-10,-2.5,0,-10.0,0,0,,0,0.0,4,-10,-2.5,0,,ryan-burger-1
1586,Shawn Charles,Arizona State,Pac-12,7,1,-10,-10.0,0,-1.4,0,0,,0,0.0,1,-10,-10.0,0,,shawn-charles-1
1587,Stefan Cobbs*,Boise State,MWC,9,2,-10,-5.0,0,-1.1,23,241,10.5,1,26.8,25,231,9.2,1,,stefan-cobbs-1
1588,Alex Mastromanno*,Florida State,ACC,14,1,-11,-11.0,0,-0.8,0,0,,0,0.0,1,-11,-11.0,0,,alex-mastromanno-1
1589,Luke Bauer*,Missouri,SEC,13,1,-11,-11.0,0,-0.8,0,0,,0,0.0,1,-11,-11.0,0,,luke-bauer-1
1590,Ben Gulbranson*,Oregon State,Pac-12,2,5,-12,-2.4,0,-6.0,0,0,,0,0.0,5,-12,-2.4,0,,ben-gulbranson-1
1591,Holden Geriner*,Auburn,SEC,5,2,-12,-6.0,0,-2.4,0,0,,0,0.0,2,-12,-6.0,0,,holden-geriner-1
1592,JT Shrout*,Arkansas State,Sun Belt,2,4,-12,-3.0,0,-6.0,1,24,24.0,0,12.0,5,12,2.4,0,,jt-shrout-1
1593,Katin Houser,Michigan State,Big Ten,11,48,-12,-0.3,2,-1.1,0,0,,0,0.0,48,-12,-0.3,2,,katin-houser-1
1594,Bryan Domino,Connecticut,Ind,8,2,-13,-6.5,0,-1.6,0,0,,0,0.0,2,-13,-6.5,0,,bryan-domino-1
1595,Cooper Allen,Army,Ind,12,1,-13,-13.0,0,-1.1,0,0,,0,0.0,1,-13,-13.0,0,,cooper-allen-1
1596,Henry Hesson*,Miami (OH),MAC,2,3,-13,-4.3,0,-6.5,0,0,,0,0.0,3,-13,-4.3,0,,henry-hesson-1
1597,Luke Larsen,East Carolina,American,11,1,-13,-13.0,0,-1.2,0,0,,0,0.0,1,-13,-13.0,0,,luke-larsen-1
1598,Micah Bowens,Charlotte,American,1,1,-13,-13.0,0,-13.0,0,0,,0,0.0,1,-13,-13.0,0,,micah-bowens-1
1599,Will Rogers,Mississippi State,SEC,8,29,-13,-0.4,1,-1.6,0,0,,0,0.0,29,-13,-0.4,1,,will-rogers-1
1600,Christian Veilleux,Pitt,ACC,7,24,-14,-0.6,0,-2.0,0,0,,0,0.0,24,-14,-0.6,0,,christian-veilleux-1
1601,Milan Tucker*,Appalachian State,Sun Belt,14,4,-14,-3.5,1,-1.0,21,305,14.5,1,21.8,25,291,11.6,2,,milan-tucker-1
1602,Shane Illingworth,Nevada,MWC,1,10,-14,-1.4,0,-14.0,0,0,,0,0.0,10,-14,-1.4,0,,shane-illingworth-1
1603,Holman Edwards,Southern Mississippi,Sun Belt,4,9,-15,-1.7,0,-3.8,0,0,,0,0.0,9,-15,-1.7,0,,holman-edwards-1
1604,Jared Wheatley*,Ohio,MAC,13,1,-15,-15.0,0,-1.2,0,0,,0,0.0,1,-15,-15.0,0,,jared-wheatley-1
1605,Emory Williams*,Miami (FL),ACC,5,7,-17,-2.4,0,-3.4,0,0,,0,0.0,7,-17,-2.4,0,,emory-williams-1
1606,Chandler Fields*,Louisiana,Sun Belt,7,29,-18,-0.6,2,-2.6,0,0,,0,0.0,29,-18,-0.6,2,,chandler-fields-1
1607,Maalik Murphy*,Texas,Big 12,7,1,-18,-18.0,0,-2.6,0,0,,0,0.0,1,-18,-18.0,0,,maalik-murphy-1
1608,Tate Rodemaker*,Florida State,ACC,9,9,-18,-2.0,0,-2.0,0,0,,0,0.0,9,-18,-2.0,0,,tate-rodemaker-1
1609,Turner Helton*,Western Kentucky,CUSA,3,4,-19,-4.8,0,-6.3,0,0,,0,0.0,4,-19,-4.8,0,,turner-helton-1
1610,Landry Lyddy,UAB,American,3,3,-20,-6.7,0,-6.7,0,0,,0,0.0,3,-20,-6.7,0,,landry-lyddy-1
1611,Cameron Edge*,Maryland,Big Ten,2,3,-21,-7.0,0,-10.5,0,0,,0,0.0,3,-21,-7.0,0,,cameron-edge-1
1612,Tayven Jackson,Indiana,Big Ten,6,28,-21,-0.8,1,-3.5,0,0,,0,0.0,28,-21,-0.8,1,,tayven-jackson-1
1613,Michael O'Shaughnessy,Michigan State,Big Ten,7,1,-22,-22.0,0,-3.1,0,0,,0,0.0,1,-22,-22.0,0,,michael-oshaughnessy-1
1614,Eddie Lee Marburger*,UTSA,American,3,7,-23,-3.3,0,-7.7,0,0,,0,0.0,7,-23,-3.3,0,,eddie-lee-marburger-1
1615,Forrest Brock,Temple,American,1,5,-25,-5.0,0,-25.0,0,0,,0,0.0,5,-25,-5.0,0,,forrest-brock-1
1616,Haden Carlson,Florida International,CUSA,3,3,-25,-8.3,0,-8.3,0,0,,0,0.0,3,-25,-8.3,0,,haden-carlson-1
1617,Kai Horton*,Tulane,American,5,24,-25,-1.0,2,-5.0,0,0,,0,0.0,24,-25,-1.0,2,,kai-horton-1
1618,Ryan Staub,Colorado,Pac-12,3,11,-26,-2.4,0,-8.7,0,0,,0,0.0,11,-26,-2.4,0,,ryan-staub-1
1619,Brayden Fowler-Nicolosi,Colorado State,MWC,12,33,-27,-0.8,1,-2.3,0,0,,0,0.0,33,-27,-0.8,1,,brayden-fowler-nicolosi-1
1620,Devin Kargman,Kent State,MAC,3,5,-29,-5.8,0,-9.7,0,0,,0,0.0,5,-29,-5.8,0,,devin-kargman-1
1621,Ben Bryant*,Northwestern,Big Ten,9,60,-33,-0.6,4,-3.7,0,0,,0,0.0,60,-33,-0.6,4,,ben-bryant-1
1622,Noah Fifita*,Arizona,Pac-12,12,38,-33,-0.9,0,-2.8,0,0,,0,0.0,38,-33,-0.9,0,,noah-fifita-1
1623,John Paddock,Illinois,Big Ten,7,12,-39,-3.3,0,-5.6,0,0,,0,0.0,12,-39,-3.3,0,,john-paddock-1
1624,Kedon Slovis,BYU,Big 12,8,29,-41,-1.4,3,-5.1,1,2,2.0,0,0.3,30,-39,-1.3,3,,kedon-slovis-1
1625,Cade McNamara*,Iowa,Big Ten,5,13,-45,-3.5,0,-9.0,0,0,,0,0.0,13,-45,-3.5,0,,cade-mcnamara-1
1626,Carter Bradley*,South Alabama,Sun Belt,11,43,-48,-1.1,1,-4.4,0,0,,0,0.0,43,-48,-1.1,1,,carter-bradley-1
1627,Michael Alaimo,Kent State,MAC,8,57,-48,-0.8,1,-6.0,0,0,,0,0.0,57,-48,-0.8,1,,michael-alaimo-1
1628,Cade McConnell,UTEP,CUSA,7,31,-49,-1.6,0,-7.0,0,0,,0,0.0,31,-49,-1.6,0,,cade-mcconnell-2
1629,Drew Pyne,Arizona State,Pac-12,2,14,-49,-3.5,0,-24.5,1,17,17.0,0,8.5,15,-32,-2.1,0,,drew-pyne-1
1630,Layne Hatcher,Ball State,MAC,7,20,-53,-2.7,1,-7.6,0,0,,0,0.0,20,-53,-2.7,1,,layne-hatcher-1
1631,Davis Brin*,Georgia Southern,Sun Belt,13,74,-60,-0.8,1,-4.6,0,0,,0,0.0,74,-60,-0.8,1,,davis-brin-1
1632,Devin Leary*,Kentucky,SEC,13,42,-60,-1.4,1,-4.6,1,-4,-4.0,0,-0.3,43,-64,-1.5,1,,devin-leary-1
1633,Daniel Richardson,Florida Atlantic,American,11,42,-62,-1.5,0,-5.6,0,0,,0,0.0,42,-62,-1.5,0,,daniel-richardson-1
1634,JT Daniels*,Rice,American,9,25,-65,-2.6,1,-7.2,0,0,,0,0.0,25,-65,-2.6,1,,jt-daniels-1
1635,Kyle McCord*,Ohio State,Big Ten,12,32,-65,-2.0,0,-5.4,0,0,,0,0.0,32,-65,-2.0,0,,kyle-mccord-1
1636,Cole Pennington*,Marshall,Sun Belt,4,15,-69,-4.6,0,-17.3,0,0,,0,0.0,15,-69,-4.6,0,,cole-pennington-1
1637,Graham Mertz,Florida,SEC,11,62,-75,-1.2,4,-6.8,0,0,,0,0.0,62,-75,-1.2,4,,graham-mertz-1
1638,Shedeur Sanders,Colorado,Pac-12,11,111,-77,-0.7,4,-7.0,0,0,,0,0.0,111,-77,-0.7,4,,shedeur-sanders-1
1639,Connor Bazelak*,Bowling Green,MAC,11,44,-82,-1.9,2,-7.5,0,0,,0,0.0,44,-82,-1.9,2,,connor-bazelak-1
1640,Dante Moore*,UCLA,Pac-12,9,45,-84,-1.9,0,-9.3,0,0,,0,0.0,45,-84,-1.9,0,,dante-moore-1
1641,Trexler Ivey,Charlotte,American,11,33,-89,-2.7,3,-8.1,0,0,,0,0.0,33,-89,-2.7,3,,trexler-ivey-1
1642,Gunnar Watson*,Troy,Sun Belt,14,51,-106,-2.1,1,-7.6,0,0,,0,0.0,51,-106,-2.1,1,,gunnar-watson-1
1643,Deacon Hill*,Iowa,Big Ten,13,50,-126,-2.5,2,-9.7,0,0,,0,0.0,50,-126,-2.5,2,,deacon-hill-1
1644,Mikey Keene*,Fresno State,MWC,12,29,-136,-4.7,1,-11.3,0,0,,0,0.0,29,-136,-4.7,1,,mikey-keene-1
1645,Jeff Undercuffler,Akron,MAC,10,26,-201,-7.7,1,-20.1,0,0,,0,0.0,26,-201,-7.7,1,,jeff-undercuffler-2